County/City,Ward,Pct,"Jill Holtzman Vogel","Bryce E. Reeves","Glenn Ray Davis, Jr.","All Others","Total Votes Cast"
,,,,,
"Accomack County",-,"101 - Chincoteague",54,82,48,0,184
"Accomack County",-,"201 - Atlantic",31,62,12,0,105
"Accomack County",-,"202 - Greenbackville",42,36,27,0,105
"Accomack County",-,"301 - New Church",27,43,16,0,86
"Accomack County",-,"401 - Bloxom",18,33,13,0,64
"Accomack County",-,"402 - Parksley",38,22,17,0,77
"Accomack County",-,"403 - Saxis",10,15,8,0,33
"Accomack County",-,"501 - Mappsville",7,29,7,0,43
"Accomack County",-,"502 - Rue",7,13,4,0,24
"Accomack County",-,"601 - Accomac",40,56,27,0,123
"Accomack County",-,"602 - Tangier",46,27,25,0,98
"Accomack County",-,"701 - Nandua",72,66,49,0,187
"Accomack County",-,"801 - Bobtown",38,28,15,0,81
"Accomack County",-,"802 - Melfa",23,30,8,0,61
"Accomack County",-,"803 - Wachapreague",24,43,24,0,91
"Accomack County",-,"901 - Painter",52,80,29,0,161
"Accomack County",-,"Ab - Central Absentee Precinct",9,10,9,0,28
"Accomack County",-,Provisional,0,0,0,0,0
"Albemarle County",-,"101 - Woodbrook",36,131,25,0,192
"Albemarle County",-,"103 - Branchlands",7,41,9,0,57
"Albemarle County",-,"104 - Agnor-hurt",14,64,8,0,86
"Albemarle County",-,"105 - Dunlora",34,100,16,0,150
"Albemarle County",-,"106 - Northside",46,108,26,0,180
"Albemarle County",-,"201 - Jack Jouett",22,101,13,0,136
"Albemarle County",-,"202 - University Hall",17,14,7,0,38
"Albemarle County",-,"203 - Georgetown",9,53,10,0,72
"Albemarle County",-,"204 - Belfield",21,52,17,0,90
"Albemarle County",-,"301 - Ivy",43,132,32,0,207
"Albemarle County",-,"302 - Red Hill",39,76,29,0,144
"Albemarle County",-,"304 - East Ivy",14,47,12,0,73
"Albemarle County",-,"305 - Country Green",25,61,15,0,101
"Albemarle County",-,"306 - Porters",15,45,14,0,74
"Albemarle County",-,"307 - Yellow Mountain",8,12,9,0,29
"Albemarle County",-,"401 - Scottsville",27,69,16,0,112
"Albemarle County",-,"402 - Monticello",27,59,21,0,107
"Albemarle County",-,"405 - Cale",34,78,18,0,130
"Albemarle County",-,"406 - Stone Robinson",58,160,48,0,266
"Albemarle County",-,"501 - Keswick",25,52,14,0,91
"Albemarle County",-,"502 - Stony Point",28,89,15,0,132
"Albemarle County",-,"503 - Hollymead",41,76,25,0,142
"Albemarle County",-,"504 - Free Bridge",40,144,32,0,216
"Albemarle County",-,"506 - Baker-butler",56,137,20,0,213
"Albemarle County",-,"601 - Crozet",67,112,32,0,211
"Albemarle County",-,"602 - Free Union",20,38,16,0,74
"Albemarle County",-,"603 - Earlysville",64,112,36,0,212
"Albemarle County",-,"604 - Brownsville",71,121,37,0,229
"Albemarle County",-,"Ab - Central Absentee Precinct",40,65,28,0,133
"Albemarle County",-,Provisional,3,1,2,0,6
"Alexandria City",-,"101 - Ladrey Senior Building",98,21,12,0,131
"Alexandria City",-,"102 - City Hall",103,35,27,0,165
"Alexandria City",-,"103 - Lyles Crouch School",109,42,28,0,179
"Alexandria City",-,"104 - Durant Center",77,25,32,0,134
"Alexandria City",-,"105 - Lee Center",65,42,21,0,128
"Alexandria City",-,"106 - Cora Kelly Center",57,25,15,0,97
"Alexandria City",-,"107 - Mt Vernon Recreation Center",99,38,27,0,164
"Alexandria City",-,"108 - George Washington Middle Sch",102,36,27,0,165
"Alexandria City",-,"109 - Fire Department Headquarters",96,36,16,0,148
"Alexandria City",-,"110 - Charles Houston Center",48,15,15,0,78
"Alexandria City",-,"201 - Maury School",81,32,29,0,142
"Alexandria City",-,"202 - George Mason School",129,38,25,0,192
"Alexandria City",-,"203 - Agudas Achim Synagogue",78,30,20,0,128
"Alexandria City",-,"204 - Blessed Sacrament Church",129,39,20,0,188
"Alexandria City",-,"205 - Douglas Macarthur School",107,43,34,0,184
"Alexandria City",-,"206 - Chinquapin Park Recreation Ctr",71,26,20,0,117
"Alexandria City",-,"207 - Temple Beth El Synagogue",122,43,36,0,201
"Alexandria City",-,"208 - Nova Arts Center",37,17,14,0,68
"Alexandria City",-,"209 - James K Polk School",56,32,18,0,106
"Alexandria City",-,"210 - The Hermitage",55,30,14,0,99
"Alexandria City",-,"302 - Patrick Henry Rec Center",26,20,11,0,57
"Alexandria City",-,"303 - Charles E Beatley Library",40,20,28,0,88
"Alexandria City",-,"304 - Samuel Tucker School",43,15,23,0,81
"Alexandria City",-,"305 - John Adams School",37,23,15,0,75
"Alexandria City",-,"306 - William Ramsay School",40,17,9,0,66
"Alexandria City",-,"307 - South Port",56,35,19,0,110
"Alexandria City",-,"308 - Cameron Station Community Ctr",105,36,29,0,170
"Alexandria City",-,"Ab - Central Absentee Precinct",169,50,45,0,264
"Alexandria City",-,Provisional,6,1,0,0,7
"Alleghany County",-,"101 - Arritt",10,34,3,0,47
"Alleghany County",-,"103 - Dameron",6,16,5,0,27
"Alleghany County",-,"201 - Humpback Bridge",4,18,7,0,29
"Alleghany County",-,"202 - Dolly Ann",8,23,12,0,43
"Alleghany County",-,"301 - Callaghan",5,25,5,0,35
"Alleghany County",-,"302 - Griffith",14,33,10,0,57
"Alleghany County",-,"401 - Low Moor",13,17,5,0,35
"Alleghany County",-,"402 - Jackson Heights",13,30,6,0,49
"Alleghany County",-,"501 - Iron Gate",5,5,1,0,11
"Alleghany County",-,"502 - Peters Switch",13,32,5,0,50
"Alleghany County",-,"601 - District 1",18,29,15,0,62
"Alleghany County",-,"701 - District 2",5,17,8,0,30
"Alleghany County",-,"Ab - Central Absentee Precinct",3,4,1,0,8
"Alleghany County",-,Provisional,0,0,0,0,0
"Amelia County",-,"101 - Number One",45,65,14,0,124
"Amelia County",-,"201 - Number Two",64,95,15,0,174
"Amelia County",-,"301 - Number Three",71,72,17,0,160
"Amelia County",-,"401 - Number Four",67,77,13,0,157
"Amelia County",-,"501 - Number Five",69,79,17,0,165
"Amelia County",-,"Ab - Central Absentee Precinct",12,5,2,0,19
"Amelia County",-,Provisional,1,1,0,0,2
"Amherst County",-,"101 - Wright Shop",21,37,14,0,72
"Amherst County",-,"102 - New Glasgow",62,68,13,0,143
"Amherst County",-,"103 - Coolwell",18,57,9,0,84
"Amherst County",-,"201 - Court House",102,126,35,0,263
"Amherst County",-,"202 - Temperance",39,64,16,0,119
"Amherst County",-,"301 - Monroe",51,50,20,0,121
"Amherst County",-,"302 - Elon",94,160,31,0,285
"Amherst County",-,"303 - Pleasant View",22,43,13,0,78
"Amherst County",-,"401 - Amelon",65,183,44,0,292
"Amherst County",-,"402 - Lonco",19,36,14,0,69
"Amherst County",-,"501 - Madison",75,120,30,0,225
"Amherst County",-,"Ab - Central Absentee Precinct",13,24,2,0,39
"Amherst County",-,Provisional,0,0,0,0,0
"Appomattox County",-,"101 - Vera",34,48,14,0,96
"Appomattox County",-,"102 - Pamplin",49,73,12,0,134
"Appomattox County",-,"201 - Chap",14,32,4,0,50
"Appomattox County",-,"202 - Spout Spring",63,104,23,0,190
"Appomattox County",-,"301 - Us 460",35,68,11,0,114
"Appomattox County",-,"302 - Stonewall",47,81,16,0,144
"Appomattox County",-,"401 - Courthouse",58,87,20,0,165
"Appomattox County",-,"501 - Oakville",45,62,19,0,126
"Appomattox County",-,"502 - Agee",25,31,3,0,59
"Appomattox County",-,"Ab - Central Absentee Precinct",9,7,0,0,16
"Appomattox County",-,Provisional,0,1,0,0,1
"Arlington County",-,"1 - Arlington",28,15,14,0,57
"Arlington County",-,"2 - Ashton Heights",36,20,18,0,74
"Arlington County",-,"3 - Aurora Hills",73,23,17,0,113
"Arlington County",-,"4 - Ballston",58,22,10,0,90
"Arlington County",-,"5 - Barcroft",55,15,7,0,77
"Arlington County",-,"6 - Crystal City",51,19,15,0,85
"Arlington County",-,"7 - Cherrydale",51,24,20,0,95
"Arlington County",-,"8 - Hume",72,40,19,0,131
"Arlington County",-,"9 - Columbia",52,21,7,0,80
"Arlington County",-,"10 - Wilson",63,19,23,0,105
"Arlington County",-,"11 - East Falls Church",55,20,18,0,93
"Arlington County",-,"12 - Fairlington",76,25,31,0,132
"Arlington County",-,"13 - Glen Carlyn",25,19,2,0,46
"Arlington County",-,"14 - Clarendon",27,13,12,0,52
"Arlington County",-,"15 - Lyon Park",32,10,9,0,51
"Arlington County",-,"16 - Lyon Village",38,29,15,0,82
"Arlington County",-,"17 - Overlee Knolls",68,17,27,0,112
"Arlington County",-,"18 - Park Lane",71,23,16,0,110
"Arlington County",-,"19 - Rosslyn",39,19,14,0,72
"Arlington County",-,"20 - Thrifton",65,29,61,0,155
"Arlington County",-,"21 - Virginia Highlands",52,16,14,0,82
"Arlington County",-,"22 - Abingdon",68,18,21,0,107
"Arlington County",-,"23 - Westover",50,17,14,0,81
"Arlington County",-,"24 - Woodlawn",55,26,20,0,101
"Arlington County",-,"25 - Arlington Forest",49,23,21,0,93
"Arlington County",-,"26 - Fillmore",43,13,12,0,68
"Arlington County",-,"27 - Jefferson",51,24,15,0,90
"Arlington County",-,"28 - Wakefield",47,13,15,0,75
"Arlington County",-,"29 - Dominion Hills",45,31,11,0,87
"Arlington County",-,"30 - Glebe",28,12,9,0,49
"Arlington County",-,"31 - Lexington",78,19,18,0,115
"Arlington County",-,"32 - Oakridge",34,19,7,0,60
"Arlington County",-,"33 - Rock Spring",90,27,31,0,148
"Arlington County",-,"34 - Yorktown",59,20,19,0,98
"Arlington County",-,"35 - Madison",127,38,45,0,210
"Arlington County",-,"36 - Marshall",86,14,15,0,115
"Arlington County",-,"37 - Nottingham",76,21,9,0,106
"Arlington County",-,"38 - Arlington View",30,9,13,0,52
"Arlington County",-,"39 - Ashlawn",33,9,5,0,47
"Arlington County",-,"40 - Virginia Square",44,27,18,0,89
"Arlington County",-,"41 - Navy League",40,16,8,0,64
"Arlington County",-,"42 - Shirlington",35,11,11,0,57
"Arlington County",-,"43 - Campbell",8,7,9,0,24
"Arlington County",-,"44 - Dawson Terrace",19,13,10,0,42
"Arlington County",-,"45 - Buckingham",34,12,10,0,56
"Arlington County",-,"46 - Central",59,31,17,0,107
"Arlington County",-,"47 - Four Mile Run",32,5,5,0,42
"Arlington County",-,"48 - Ausa",31,12,3,0,46
"Arlington County",-,"49 - Monroe",18,10,14,0,42
"Arlington County",-,"50 - Crystal Plaza",44,17,11,0,72
"Arlington County",-,"51 - Taylor",19,9,8,0,36
"Arlington County",-,"52 - Gunston",32,13,11,0,56
"Arlington County",-,"53 - Met Park",39,19,11,0,69
"Arlington County",-,"54 - Garfield Park",17,12,10,0,39
"Arlington County",-,"Ab - Central Absentee Precinct",127,73,43,0,243
"Arlington County",-,Provisional,0,1,0,0,1
"Augusta County",-,"101 - Jolivue",32,34,56,0,122
"Augusta County",-,"102 - Stuarts Draft Elementary",40,29,32,0,101
"Augusta County",-,"103 - Verona",46,63,91,0,200
"Augusta County",-,"201 - Crimora",48,99,39,0,186
"Augusta County",-,"202 - New Hope",52,56,48,0,156
"Augusta County",-,"203 - Weyers Cave",73,53,61,0,187
"Augusta County",-,"301 - Fort Defiance",63,149,129,0,341
"Augusta County",-,"302 - North River",43,23,27,0,93
"Augusta County",-,"303 - Mount Solon",54,62,43,0,159
"Augusta County",-,"304 - Churchville Fire Station",41,46,30,0,117
"Augusta County",-,"401 - Buffalo Gap",31,32,41,0,104
"Augusta County",-,"402 - Churchville Elementary",46,58,32,0,136
"Augusta County",-,"403 - Craigsville",23,31,25,0,79
"Augusta County",-,"404 - Deerfield",20,12,18,0,50
"Augusta County",-,"405 - Cedar Green",55,66,43,0,164
"Augusta County",-,"501 - Greenville",59,59,52,0,170
"Augusta County",-,"502 - Middlebrook",37,31,36,0,104
"Augusta County",-,"503 - Spottswood",32,46,38,0,116
"Augusta County",-,"504 - White Hill",80,87,80,0,247
"Augusta County",-,"601 - Sherando",42,78,42,0,162
"Augusta County",-,"602 - Ridgeview",77,221,73,0,371
"Augusta County",-,"603 - Lyndhurst",68,100,71,0,239
"Augusta County",-,"801 - Dooms",56,101,34,0,191
"Augusta County",-,"802 - Fishersville",93,105,133,0,331
"Augusta County",-,"803 - Wilson",77,65,50,0,192
"Augusta County",-,"Ab - Central Absentee Precinct",37,42,26,0,105
"Augusta County",-,Provisional,0,0,0,0,0
"Bath County",-,"101 - Warm Springs",20,20,8,0,48
"Bath County",-,"102 - Mountain Grove",7,9,6,0,22
"Bath County",-,"201 - Hot Springs",10,19,5,0,34
"Bath County",-,"301 - Fairview",10,18,10,0,38
"Bath County",-,"302 - Burnsville",2,4,3,0,9
"Bath County",-,"401 - Millboro",12,24,10,0,46
"Bath County",-,"501 - Healing Springs",10,25,6,0,41
"Bath County",-,"Ab - Central Absentee Precinct",4,5,0,0,9
"Bath County",-,Provisional,0,0,0,0,0
"Bedford County",-,"101 - Goodview Elem School (CD 5)",37,118,21,0,176
"Bedford County",-,"102 - Hardy Vol Fire Co (CD 5)",27,49,20,0,96
"Bedford County",-,"103 - Chamblissburg Baptist Church (CD 5)",23,79,24,0,126
"Bedford County",-,"104 - Stewartsville Rescue Squad (CD 5)",32,79,15,0,126
"Bedford County",-,"201 - Bedford Christian Church (CD 5)",25,45,16,0,86
"Bedford County",-,"202 - Staunton River High School (CD 5)",29,53,19,0,101
"Bedford County",-,"203 - Moneta Elem School (CD 5)",69,118,34,0,221
"Bedford County",-,"204 - Quaker Baptist Church (CD 5)",17,32,9,0,58
"Bedford County",-,"205 - Saunders Vol Fire Co (CD 5)",60,118,42,0,220
"Bedford County",-,"301 - New London Academy (CD 6)",212,293,98,0,603
"Bedford County",-,"302 - Bedford Regional Water Auth (CD 5)",70,120,40,0,230
"Bedford County",-,"303 - Bethesda United Methodist Church (CD 5)",40,103,28,0,171
"Bedford County",-,"304 - Forest Youth Athletic Assoc (CD 6)",62,61,24,0,147
"Bedford County",-,"305 - Huddleston Elem School (CD 5)",44,73,13,0,130
"Bedford County",-,"401 - Forest Elementary School (CD 6)",174,193,67,0,434
"Bedford County",-,"402 - Thomas Jefferson Elem School (CD 6)",79,92,26,0,197
"Bedford County",-,"403 - Knights Of Columbus Bldg (CD 6)",189,217,91,0,497
"Bedford County",-,"404 - St. Paul Baptist Church (CD 6)",173,215,65,0,453
"Bedford County",-,"502 - Big Island Elem School (CD 6)",10,24,11,0,45
"Bedford County",-,"503 - Sedalia Center (CD 6)",27,33,21,0,81
"Bedford County",-,"504 - Suck Springs Baptist Church (CD 6)",55,85,32,0,172
"Bedford County",-,"505 - Boonsboro Elementary School (CD 6)",115,110,37,0,262
"Bedford County",-,"506 - Boonsboro Ruritan Club (CD 6)",151,141,56,0,348
"Bedford County",-,"601 - Montvale Elem School (CD 6)",34,81,31,0,146
"Bedford County",-,"602 - Shady Grove Fire Department (CD 5)",43,87,14,0,144
"Bedford County",-,"603 - Thaxton Baptist Church #1 (CD 5)",11,15,11,0,37
"Bedford County",-,"604 - Bedford Welcome Center (CD 5)",51,84,37,0,172
"Bedford County",-,"701 - Goode Vol Rescue Squad (CD 5)",86,156,48,0,290
"Bedford County",-,"702 - Liberty High School (CD 5)",46,91,21,0,158
"Bedford County",-,"703 - Thaxton Baptist Church #2 (CD 5)",37,38,23,0,98
"Bedford County",-,"704 - Bedford Central Library (CD 5)",47,88,49,0,184
"Bedford County",-,"Ab - Central Absentee Precinct (CD 5)",44,23,10,0,77
"Bedford County",-,"Ab - Central Absentee Precinct (CD 6)",37,49,10,0,96
"Bedford County",-,"Provisional (CD 5)",0,0,0,0,0
"Bedford County",-,"Provisional (CD 6)",0,1,1,0,2
"Bland County",-,"101 - Bastian",9,18,13,0,40
"Bland County",-,"102 - Ceres",20,21,8,0,49
"Bland County",-,"201 - Davis",3,7,2,0,12
"Bland County",-,"202 - Seddon",15,48,21,0,84
"Bland County",-,"301 - Hollybrook",7,22,3,0,32
"Bland County",-,"302 - Mechanicsburg",4,7,6,0,17
"Bland County",-,"401 - Rocky Gap",41,34,20,0,95
"Bland County",-,"Ab - Central Absentee Precinct",3,5,0,0,8
"Bland County",-,Provisional,0,0,0,0,0
"Botetourt County",-,"101 - Daleville",70,87,29,0,186
"Botetourt County",-,"102 - Greenfield",101,136,39,0,276
"Botetourt County",-,"201 - Blue Ridge",74,130,21,0,225
"Botetourt County",-,"202 - Rainbow Forest",67,126,24,0,217
"Botetourt County",-,"301 - Buchanan",45,62,17,0,124
"Botetourt County",-,"302 - Mill Creek",45,93,35,0,173
"Botetourt County",-,"403 - Eagle Rock",24,70,5,0,99
"Botetourt County",-,"406 - Fincastle",58,133,36,0,227
"Botetourt County",-,"501 - Troutville",29,73,14,0,116
"Botetourt County",-,"502 - Cloverdale",77,167,38,0,282
"Botetourt County",-,"Ab - Central Absentee Precinct",21,27,17,0,65
"Botetourt County",-,Provisional,0,0,0,0,0
"Bristol City",-,"1 - First Ward",30,34,32,0,96
"Bristol City",-,"2 - Second Ward",55,46,33,0,134
"Bristol City",-,"3 - Third Ward",25,26,15,0,66
"Bristol City",-,"4 - Fourth Ward",92,73,41,0,206
"Bristol City",-,"Ab - Central Absentee Precinct",8,3,2,0,13
"Bristol City",-,Provisional,0,0,0,0,0
"Brunswick County",-,"101 - Brodnax",13,23,9,0,45
"Brunswick County",-,"102 - Rock Store",12,29,3,0,44
"Brunswick County",-,"103 - Tillman",36,37,14,0,87
"Brunswick County",-,"201 - Dromgoole",7,6,0,0,13
"Brunswick County",-,"202 - Edgerton",9,22,2,0,33
"Brunswick County",-,"203 - Fitzhugh",7,10,3,0,20
"Brunswick County",-,"301 - Alberta",8,10,0,0,18
"Brunswick County",-,"302 - Danieltown",12,36,7,0,55
"Brunswick County",-,"303 - Elmore",3,18,3,0,24
"Brunswick County",-,"304 - Seymour",4,8,3,0,15
"Brunswick County",-,"401 - Sturgeon",16,35,5,0,56
"Brunswick County",-,"402 - King's Store",3,7,1,0,11
"Brunswick County",-,"501 - Totaro",17,16,5,0,38
"Brunswick County",-,"Ab - Central Absentee Precinct",6,5,1,0,12
"Brunswick County",-,Provisional,0,0,0,0,0
"Buchanan County",-,"102 - Blackey",8,4,1,0,13
"Buchanan County",-,"103 - Hurley",27,22,4,0,53
"Buchanan County",-,"201 - Grassy",1,2,0,0,3
"Buchanan County",-,"202 - Bull",4,15,14,0,33
"Buchanan County",-,"203 - Rocklick",3,8,4,0,15
"Buchanan County",-,"301 - Slate",9,9,1,0,19
"Buchanan County",-,"302 - North Grundy",9,9,7,0,25
"Buchanan County",-,"403 - South Grundy",8,14,8,0,30
"Buchanan County",-,"404 - Oakwood",2,0,0,0,2
"Buchanan County",-,"501 - Prater",5,3,1,0,9
"Buchanan County",-,"502 - Fox",2,1,3,0,6
"Buchanan County",-,"503 - Vansant",1,3,5,0,9
"Buchanan County",-,"601 - Council",0,3,5,0,8
"Buchanan County",-,"602 - Garden",1,9,8,0,18
"Buchanan County",-,"603 - Hurricane",0,9,5,0,14
"Buchanan County",-,"701 - Whitewood",11,7,13,0,31
"Buchanan County",-,"702 - Contrary",5,8,7,0,20
"Buchanan County",-,"Ab - Central Absentee Precinct",7,20,6,0,33
"Buchanan County",-,Provisional,0,0,0,0,0
"Buckingham County",-,"101 - New Canton",38,60,18,0,116
"Buckingham County",-,"102 - Georgia Creek",6,16,7,0,29
"Buckingham County",-,"201 - White Hall",12,37,18,0,67
"Buckingham County",-,"301 - Curdsville",34,36,15,0,85
"Buckingham County",-,"302 - New Store",28,46,21,0,95
"Buckingham County",-,"401 - Maysville",48,56,17,0,121
"Buckingham County",-,"501 - Wrights",18,30,15,0,63
"Buckingham County",-,"502 - Glenmore",19,35,18,0,72
"Buckingham County",-,"601 - Slate River",19,40,13,0,72
"Buckingham County",-,"701 - Gold Hill",27,35,11,0,73
"Buckingham County",-,"Ab - Central Absentee Precinct",6,10,7,0,23
"Buckingham County",-,Provisional,0,0,0,0,0
"Buena Vista City",-,"1 - First Ward",26,70,28,0,124
"Buena Vista City",-,"2 - Second Ward",31,41,20,0,92
"Buena Vista City",-,Provisional,0,0,0,0,0
"Campbell County",-,"101 - Brookville",88,165,44,0,297
"Campbell County",-,"102 - New London",90,131,50,0,271
"Campbell County",-,"201 - Walker",61,95,28,0,184
"Campbell County",-,"202 - Bedford Springs",112,143,47,0,302
"Campbell County",-,"301 - Evington",30,34,17,0,81
"Campbell County",-,"302 - Otter River",23,41,12,0,76
"Campbell County",-,"303 - Altavista",54,105,25,0,184
"Campbell County",-,"401 - Three Forks",69,98,20,0,187
"Campbell County",-,"402 - Court House",99,160,41,0,300
"Campbell County",-,"501 - Spring Hill",81,129,42,0,252
"Campbell County",-,"502 - Yellow Branch",35,84,28,0,147
"Campbell County",-,"601 - Kings",60,65,25,0,150
"Campbell County",-,"602 - Concord",72,133,33,0,238
"Campbell County",-,"701 - Brookneal",30,53,26,0,109
"Campbell County",-,"702 - Gladys",43,96,20,0,159
"Campbell County",-,"703 - Morris Church",27,41,7,0,75
"Campbell County",-,"Ab - Central Absentee Precinct",21,35,11,0,67
"Campbell County",-,Provisional,0,0,0,0,0
"Caroline County",-,"101 - Bowling Green",52,112,10,0,174
"Caroline County",-,"102 - Sparta",39,62,5,0,106
"Caroline County",-,"201 - North Madison",24,52,10,0,86
"Caroline County",-,"202 - South Madison",31,58,18,0,107
"Caroline County",-,"301 - Port Royal",39,42,10,0,91
"Caroline County",-,"302 - Woodford",41,153,22,0,216
"Caroline County",-,"401 - Dawn",38,56,11,0,105
"Caroline County",-,"402 - Carmel Church",10,17,7,0,34
"Caroline County",-,"501 - West Mattaponi",26,48,2,0,76
"Caroline County",-,"502 - Milford",25,52,7,0,84
"Caroline County",-,"601 - Chilesburg",26,77,7,0,110
"Caroline County",-,"602 - Lake",23,53,13,0,89
"Caroline County",-,"Ab - Central Absentee Precinct",18,27,4,0,49
"Caroline County",-,Provisional,0,0,0,0,0
"Carroll County",-,"101 - Mt Bethel",21,33,13,0,67
"Carroll County",-,"102 - St Paul",29,77,53,0,159
"Carroll County",-,"103 - Lambsburg",29,54,28,1,112
"Carroll County",-,"105 - Fancy Gap",23,33,22,0,78
"Carroll County",-,"201 - Hillsville B",71,116,63,0,250
"Carroll County",-,"202 - Laurel Fork",18,42,13,0,73
"Carroll County",-,"203 - Gladesboro",16,53,30,0,99
"Carroll County",-,"301 - Hillsville C",38,75,36,0,149
"Carroll County",-,"302 - Sylvatus",11,38,12,0,61
"Carroll County",-,"303 - Dugspur",14,16,7,0,37
"Carroll County",-,"402 - Woodlawn D",26,67,31,0,124
"Carroll County",-,"403 - Oakland D",12,42,14,0,68
"Carroll County",-,"405 - Oakland A",13,19,9,0,41
"Carroll County",-,"406 - Woodlawn F",6,18,4,0,28
"Carroll County",-,"501 - Vaughan",11,30,10,0,51
"Carroll County",-,"502 - Gladeville",22,87,16,0,125
"Carroll County",-,"503 - Woodlawn E",15,34,12,0,61
"Carroll County",-,"504 - Laurel",9,48,7,0,64
"Carroll County",-,"Ab - Central Absentee Precinct",24,27,12,0,63
"Carroll County",-,Provisional,0,0,0,0,0
"Charles City County",-,"101 - Precinct 1-1",50,25,11,0,86
"Charles City County",-,"201 - Precinct 2-1",21,19,9,0,49
"Charles City County",-,"301 - Precinct 3-1",41,41,12,0,94
"Charles City County",-,"Ab - Central Absentee Precinct",5,6,2,0,13
"Charles City County",-,Provisional,0,0,0,0,0
"Charlotte County",-,"101 - County Seat",29,41,20,0,90
"Charlotte County",-,"201 - Red Oak Wylliesburg",20,46,20,0,86
"Charlotte County",-,"302 - Drakes Branch",12,23,11,0,46
"Charlotte County",-,"401 - Keysville",25,34,11,0,70
"Charlotte County",-,"501 - Cullen/Red House",14,48,4,0,66
"Charlotte County",-,"602 - Phenix",29,49,8,0,86
"Charlotte County",-,"702 - Bacon/Saxe",8,27,13,0,48
"Charlotte County",-,"Ab - Central Absentee Precinct",0,5,2,0,7
"Charlotte County",-,Provisional,1,0,0,0,1
"Charlottesville City",-,"101 - Recreation",21,34,10,0,65
"Charlottesville City",-,"102 - Clark",18,25,13,0,56
"Charlottesville City",-,"201 - Carver",9,15,5,0,29
"Charlottesville City",-,"202 - Walker",32,57,15,0,104
"Charlottesville City",-,"301 - Benjamin Tonsler",19,17,8,0,44
"Charlottesville City",-,"302 - Johnson",28,41,11,0,80
"Charlottesville City",-,"303 - Buford",5,9,2,0,16
"Charlottesville City",-,"401 - Venable",4,3,5,0,12
"Charlottesville City",-,"402 - Alumni Hall",16,31,7,0,54
"Charlottesville City",-,"Ab - Central Absentee Precinct",15,13,10,0,38
"Charlottesville City",-,Provisional,0,0,0,0,0
"Chesapeake City",-,"1 - Great Bridge (CD 4)",102,112,98,0,312
"Chesapeake City",-,"2 - Bethel (CD 4)",112,98,97,1,308
"Chesapeake City",-,"3 - Camelot (CD 3)",15,20,6,0,41
"Chesapeake City",-,"4 - Churchland (CD 3)",92,90,72,0,254
"Chesapeake City",-,"5 - Crestwood (CD 3)",14,9,8,0,31
"Chesapeake City",-,"6 - Deep Creek (CD 4)",123,80,74,0,277
"Chesapeake City",-,"7 - Greenbrier (CD 4)",112,114,81,0,307
"Chesapeake City",-,"8 - South Norfolk Recreation (CD 3)",64,83,50,0,197
"Chesapeake City",-,"9 - Bells Mill (CD 4)",141,221,117,0,479
"Chesapeake City",-,"10 - Oscar Smith (CD 3)",38,34,23,0,95
"Chesapeake City",-,"11 - Geneva Park (CD 3)",42,69,42,0,153
"Chesapeake City",-,"12 - Georgetown (CD 3)",5,27,11,0,43
"Chesapeake City",-,"13 - Gilmerton (CD 3)",53,57,59,0,169
"Chesapeake City",-,"14 - Grassfield (CD 4)",18,30,20,0,68
"Chesapeake City",-,"15 - B M Williams (CD 3)",38,47,19,0,104
"Chesapeake City",-,"16 - Hickory Grove (CD 4)",103,97,83,1,284
"Chesapeake City",-,"17 - Indian Creek (CD 4)",66,89,38,0,193
"Chesapeake City",-,"18 - Indian River (CD 3)",37,32,18,0,87
"Chesapeake City",-,"19 - Jolliff (CD 4)",105,73,49,0,227
"Chesapeake City",-,"20 - E W Chittum (CD 3)",0,1,0,0,1
"Chesapeake City",-,"20 - E W Chittum (CD 4)",105,111,71,1,288
"Chesapeake City",-,"21 - Fellowship (CD 3)",101,111,68,0,280
"Chesapeake City",-,"22 - Norfolk Highlands (CD 3)",49,61,33,0,143
"Chesapeake City",-,"23 - Oak Grove (CD 4)",60,71,34,0,165
"Chesapeake City",-,"24 - Oaklette (CD 3)",60,43,31,0,134
"Chesapeake City",-,"25 - St Julians (CD 3)",34,32,16,0,82
"Chesapeake City",-,"26 - Johnson Park (CD 3)",14,23,15,0,52
"Chesapeake City",-,"27 - Silverwood (CD 3)",125,119,94,0,338
"Chesapeake City",-,"28 - Sunray I (CD 4)",20,25,12,0,57
"Chesapeake City",-,"29 - Tanglewood (CD 3)",102,82,62,0,246
"Chesapeake City",-,"30 - South Norfolk (CD 3)",2,2,0,0,4
"Chesapeake City",-,"31 - Carver School (CD 3)",12,18,7,0,37
"Chesapeake City",-,"32 - Providence (CD 3)",3,10,3,0,16
"Chesapeake City",-,"33 - Westover (CD 3)",47,69,21,0,137
"Chesapeake City",-,"34 - Hickory Middle School (CD 4)",122,166,95,0,383
"Chesapeake City",-,"35 - Taylor Road (CD 3)",46,36,15,0,97
"Chesapeake City",-,"36 - Great Bridge Baptist Church (CD 4)",99,187,79,0,365
"Chesapeake City",-,"37 - Bridgetown (CD 4)",81,69,79,0,229
"Chesapeake City",-,"38 - Bailey Creek (CD 3)",106,117,67,0,290
"Chesapeake City",-,"39 - Lake Drummond (CD 4)",46,56,44,0,146
"Chesapeake City",-,"40 - River Birch (CD 3)",69,97,69,0,235
"Chesapeake City",-,"41 - John T West (CD 4)",97,92,61,0,250
"Chesapeake City",-,"42 - Parkways (CD 3)",42,71,28,0,141
"Chesapeake City",-,"43 - Pleasant Crossing (CD 4)",104,129,82,0,315
"Chesapeake City",-,"44 - Nansemond (CD 3)",43,67,38,0,148
"Chesapeake City",-,"45 - Sunray II (CD 4)",25,15,16,0,56
"Chesapeake City",-,"46 - Bells Mill II (CD 4)",39,40,108,0,187
"Chesapeake City",-,"47 - Green Sea (CD 4)",55,74,24,0,153
"Chesapeake City",-,"48 - Jolliff Middle School (CD 4)",16,21,8,0,45
"Chesapeake City",-,"49 - Waterway (CD 4)",158,177,136,0,471
"Chesapeake City",-,"50 - River Walk (CD 4)",69,81,39,0,189
"Chesapeake City",-,"51 - Coopers Way (CD 4)",131,128,121,0,380
"Chesapeake City",-,"52 - Shipyard Road (CD 4)",50,46,39,0,135
"Chesapeake City",-,"53 - Fairways (CD 3)",48,44,47,0,139
"Chesapeake City",-,"54 - Pughsville (CD 3)",42,40,26,0,108
"Chesapeake City",-,"55 - Georgetown East (CD 3)",28,37,11,0,76
"Chesapeake City",-,"56 - Green Tree (CD 3)",42,52,34,0,128
"Chesapeake City",-,"57 - Cypress (CD 3)",49,60,40,0,149
"Chesapeake City",-,"58 - Expressway (CD 4)",17,21,13,0,51
"Chesapeake City",-,"59 - Clearfield (CD 4)",56,45,53,0,154
"Chesapeake City",-,"60 - Parker Road (CD 4)",112,102,88,0,302
"Chesapeake City",-,"61 - Centerville (CD 4)",79,85,83,0,247
"Chesapeake City",-,"62 - Fentress (CD 4)",105,109,77,0,291
"Chesapeake City",-,"63 - Poplar Branch (CD 4)",68,74,44,0,186
"Chesapeake City",-,"AB - Central Absentee Precinct (CD 3)",32,32,30,0,94
"Chesapeake City",-,"Ab - Central Absentee Precinct (CD 4)",78,59,67,0,204
"Chesapeake City",-,"Provisional (CD 3)",1,0,1,0,2
"Chesapeake City",-,"Provisional (CD 4)",1,2,2,0,5
"Chesterfield County",-,"101 - Bellwood (CD 4)",50,63,11,0,124
"Chesterfield County",-,"102 - South Chester (CD 4)",86,111,30,0,227
"Chesterfield County",-,"103 - Enon (CD 4)",126,119,35,0,280
"Chesterfield County",-,"104 - North Chester (CD 4)",148,149,34,0,331
"Chesterfield County",-,"105 - Drewrys Bluff (CD 7)",65,70,7,0,142
"Chesterfield County",-,"106 - Harrowgate (CD 4)",154,129,33,0,316
"Chesterfield County",-,"107 - Wells (CD 4)",113,114,31,1,259
"Chesterfield County",-,"108 - Ecoff (CD 4)",270,190,66,0,526
"Chesterfield County",-,"109 - Elizabeth Scott (CD 4)",171,118,36,0,325
"Chesterfield County",-,"110 - Dutch Gap (CD 4)",97,40,10,0,147
"Chesterfield County",-,"111 - Iron Bridge (CD 4)",181,149,43,0,373
"Chesterfield County",-,"112 - Carver (CD 4)",105,77,22,0,204
"Chesterfield County",-,"201 - Gates (CD 4)",95,98,18,0,211
"Chesterfield County",-,"202 - Beulah (CD 7)",100,97,18,0,215
"Chesterfield County",-,"203 - Bird (CD 4)",21,25,3,0,49
"Chesterfield County",-,"204 - Jacobs (CD 7)",58,67,12,0,137
"Chesterfield County",-,"205 - Falling Creek (CD 7)",89,118,30,0,237
"Chesterfield County",-,"206 - Belmont (CD 7)",20,30,6,0,56
"Chesterfield County",-,"207 - Chippenham (CD 7)",22,16,6,0,44
"Chesterfield County",-,"208 - Meadowbrook (CD 7)",68,65,12,0,145
"Chesterfield County",-,"209 - Salem Church (CD 4)",124,107,32,0,263
"Chesterfield County",-,"210 - Five Forks (CD 7)",102,107,31,0,240
"Chesterfield County",-,"211 - Nash (CD 4)",226,183,64,0,473
"Chesterfield County",-,"212 - St. Luke's (CD 7)",69,107,23,0,199
"Chesterfield County",-,"213 - Southside (CD 7)",68,75,18,0,161
"Chesterfield County",-,"214 - Hopkins (CD 7)",0,3,2,0,5
"Chesterfield County",-,"215 - North Bird (CD 7)",24,19,6,0,49
"Chesterfield County",-,"301 - Ettrick (CD 4)",29,18,18,0,65
"Chesterfield County",-,"302 - Deer Run (CD 7)",63,48,13,0,124
"Chesterfield County",-,"303 - Matoaca (CD 4)",95,93,38,0,226
"Chesterfield County",-,"304 - Winfrees Store (CD 4)",120,263,29,0,412
"Chesterfield County",-,"305 - Beach (CD 4)",72,103,20,0,195
"Chesterfield County",-,"306 - Winterpock (CD 7)",181,237,32,0,450
"Chesterfield County",-,"307 - Cosby (CD 7)",117,104,20,0,241
"Chesterfield County",-,"308 - South Manchester (CD 7)",24,29,5,0,58
"Chesterfield County",-,"309 - Skinquarter (CD 7)",183,213,37,0,433
"Chesterfield County",-,"310 - Tomahawk (CD 7)",221,125,53,0,399
"Chesterfield County",-,"313 - Woolridge (CD 7)",171,168,26,0,365
"Chesterfield County",-,"315 - Bailey Bridge (CD 7)",165,197,27,0,389
"Chesterfield County",-,"316 - Spring Run (CD 7)",105,90,27,0,222
"Chesterfield County",-,"317 - Birkdale (CD 7)",204,157,23,0,384
"Chesterfield County",-,"318 - West Beach (CD 7)",50,44,10,0,104
"Chesterfield County",-,"401 - Harbour Pointe (CD 7)",112,72,23,0,207
"Chesterfield County",-,"402 - Genito (CD 7)",118,165,31,0,314
"Chesterfield County",-,"403 - Brandermill (CD 7)",164,106,22,0,292
"Chesterfield County",-,"404 - Providence (CD 7)",103,118,20,0,241
"Chesterfield County",-,"405 - La Prade (CD 7)",159,151,40,0,350
"Chesterfield County",-,"406 - Smoketree (CD 7)",172,121,51,0,344
"Chesterfield County",-,"407 - Monacan (CD 7)",81,96,28,0,205
"Chesterfield County",-,"408 - Reams (CD 7)",121,117,35,0,273
"Chesterfield County",-,"409 - Manchester (CD 7)",85,70,14,0,169
"Chesterfield County",-,"410 - Wagstaff (CD 7)",76,83,22,0,181
"Chesterfield County",-,"411 - Swift Creek (CD 7)",187,92,38,0,317
"Chesterfield County",-,"413 - Shenandoah (CD 7)",108,139,20,0,267
"Chesterfield County",-,"414 - Crenshaw (CD 7)",125,160,26,0,311
"Chesterfield County",-,"415 - Evergreen (CD 7)",139,96,27,0,262
"Chesterfield County",-,"416 - Evergreen West (CD 7)",51,27,18,0,96
"Chesterfield County",-,"417 - Edgewater (CD 7)",62,40,12,0,114
"Chesterfield County",-,"501 - Huguenot (CD 7)",109,90,26,0,225
"Chesterfield County",-,"502 - Crestwood (CD 7)",59,90,16,0,165
"Chesterfield County",-,"503 - Midlothian (CD 7)",164,148,32,0,344
"Chesterfield County",-,"504 - Robious (CD 7)",276,178,46,0,500
"Chesterfield County",-,"505 - Bon Air (CD 7)",175,174,37,0,386
"Chesterfield County",-,"506 - Greenfield (CD 7)",139,110,29,0,278
"Chesterfield County",-,"507 - Salisbury (CD 7)",222,152,173,0,547
"Chesterfield County",-,"508 - Belgrade (CD 7)",129,154,20,0,303
"Chesterfield County",-,"509 - Cranbeck (CD 7)",76,79,15,0,170
"Chesterfield County",-,"510 - Sycamore (CD 7)",182,112,32,0,326
"Chesterfield County",-,"511 - Black Heath (CD 7)",123,96,32,0,251
"Chesterfield County",-,"513 - Beaufont (CD 7)",20,32,9,0,61
"Chesterfield County",-,"514 - Watkins (CD 7)",222,154,38,0,414
"Chesterfield County",-,"515 - Davis (CD 7)",30,32,14,0,76
"Chesterfield County",-,"516 - Pocoshock (CD 7)",26,24,5,0,55
"Chesterfield County",-,"517 - Roseland (CD 7)",63,46,8,0,117
"Chesterfield County",-,"518 - Midlothian North (CD 7)",183,125,46,0,354
"Chesterfield County",-,"Ab - Central Absentee Precinct (CD 4)",58,54,18,0,130
"Chesterfield County",-,"Ab - Central Absentee Precinct (CD 7)",104,123,27,0,254
"Chesterfield County",-,"Provisional (CD 4)",0,0,0,0,0
"Chesterfield County",-,"Provisional (CD 7)",0,1,0,0,1
"Clarke County",-,"101 - Russell",166,48,12,0,226
"Clarke County",-,"201 - Berryville",125,29,10,0,164
"Clarke County",-,"301 - Millwood",112,24,7,0,143
"Clarke County",-,"302 - Pine Grove",60,8,8,0,76
"Clarke County",-,"401 - White Post",165,28,13,0,206
"Clarke County",-,"501 - Buckmarsh",95,26,13,0,134
"Clarke County",-,"502 - Blue Ridge",32,12,4,0,48
"Clarke County",-,"Ab - Central Absentee Precinct",24,5,1,0,30
"Clarke County",-,Provisional,0,0,0,0,0
"Colonial Heights City",-,"1 - First",42,67,23,0,132
"Colonial Heights City",-,"2 - Second",57,73,22,0,152
"Colonial Heights City",-,"3 - Third",102,93,58,0,253
"Colonial Heights City",-,"4 - Fourth",81,116,95,0,292
"Colonial Heights City",-,"5 - Fifth",127,121,114,0,362
"Colonial Heights City",-,"Ab - Central Absentee Precinct",27,30,8,0,65
"Colonial Heights City",-,Provisional,0,0,0,0,0
"Covington City",-,"101 - Precinct 1-1",6,7,1,0,14
"Covington City",-,"201 - Precinct 2-1",5,10,7,0,22
"Covington City",-,"301 - Precinct 3-1",2,6,2,0,10
"Covington City",-,"401 - Precinct 4-1",17,35,5,0,57
"Covington City",-,"501 - Precinct 5-1",5,26,11,0,42
"Covington City",-,"Ab - Central Absentee Precinct",0,3,2,0,5
"Covington City",-,Provisional,0,0,0,0,0
"Craig County",-,"101 - Court House",13,48,5,0,66
"Craig County",-,"201 - Ammendale Precinct",34,37,16,0,87
"Craig County",-,"301 - Givens & Reynolds Store",11,17,6,0,34
"Craig County",-,"303 - Marshalls Store",8,14,3,0,25
"Craig County",-,"401 - Barbours Creek",8,11,1,0,20
"Craig County",-,"402 - Paint Bank",0,5,1,0,6
"Craig County",-,"403 - Craig Springs",8,17,4,0,29
"Craig County",-,"501 - Craig City",17,31,10,0,58
"Craig County",-,Provisional,0,0,0,0,0
"Culpeper County",-,"101 - West Fairfax",78,175,23,0,276
"Culpeper County",-,"201 - East Fairfax",44,99,19,0,162
"Culpeper County",-,"302 - Eggbornsville",69,107,11,0,187
"Culpeper County",-,"303 - Cardova",52,99,17,0,168
"Culpeper County",-,"304 - Willow Shade",19,32,6,0,57
"Culpeper County",-,"401 - Eldorado",60,125,16,0,201
"Culpeper County",-,"402 - Browns Store",125,254,38,0,417
"Culpeper County",-,"501 - Jeffersonton",151,108,37,0,296
"Culpeper County",-,"502 - Rixeyville",148,116,28,0,292
"Culpeper County",-,"601 - Mitchells",15,30,6,0,51
"Culpeper County",-,"602 - Pearl Sample",93,184,19,0,296
"Culpeper County",-,"603 - South Ridge",27,45,2,0,74
"Culpeper County",-,"702 - Brandy Station",112,161,28,0,301
"Culpeper County",-,"703 - Lignum",41,81,9,0,131
"Culpeper County",-,"704 - Richardsville",22,65,11,0,98
"Culpeper County",-,"Ab - Central Absentee Precinct",25,54,10,0,89
"Culpeper County",-,Provisional,1,0,0,0,1
"Cumberland County",-,"101 - Precinct 1",74,70,7,0,151
"Cumberland County",-,"201 - Precinct 2",65,87,10,0,162
"Cumberland County",-,"301 - Precinct 3",34,23,4,0,61
"Cumberland County",-,"401 - Precinct 4",50,56,10,0,116
"Cumberland County",-,"501 - Precinct 5",28,65,13,0,106
"Cumberland County",-,"Ab - Central Absentee Precinct",11,9,1,0,21
"Cumberland County",-,Provisional,0,0,0,0,0
"Danville City",-,"1 - Ward One",2,4,3,0,9
"Danville City",-,"2 - Ward Two",13,18,5,0,36
"Danville City",-,"3 - Ward Three",30,31,14,0,75
"Danville City",-,"4 - Ward Four",72,77,30,0,179
"Danville City",-,"6 - Ward Six",4,6,3,0,13
"Danville City",-,"7 - Ward Seven",2,10,8,0,20
"Danville City",-,"8 - Ward Eight",12,26,11,0,49
"Danville City",-,"9 - Ward Nine",20,36,12,0,68
"Danville City",-,"10 - Ward Ten",29,55,17,0,101
"Danville City",-,"11 - Ward Eleven",42,38,7,0,87
"Danville City",-,"12 - Ward Twelve",42,69,17,0,128
"Danville City",-,"13 - Ward Thirteen",37,34,7,0,78
"Danville City",-,"14 - Ward Fourteen",0,0,0,0,0
"Danville City",-,"15 - Ward Fifteen",48,42,14,0,104
"Danville City",-,"16 - Ward Sixteen",41,91,26,0,158
"Danville City",-,"17 - Ward Seventeen",60,81,32,0,173
"Danville City",-,"Ab - Central Absentee Precinct",13,28,11,0,52
"Danville City",-,Provisional,0,0,0,0,0
"Dickenson County",-,"101 - South Clintwood",15,29,12,0,56
"Dickenson County",-,"201 - Nora",2,3,10,0,15
"Dickenson County",-,"202 - Frying Pan",3,7,2,0,12
"Dickenson County",-,"203 - Clinchco",4,5,5,0,14
"Dickenson County",-,"301 - West Dante",5,5,8,0,18
"Dickenson County",-,"302 - Herald",5,10,11,0,26
"Dickenson County",-,"303 - Ridge",2,13,5,0,20
"Dickenson County",-,"401 - Haysi-colley",9,8,10,0,27
"Dickenson County",-,"501 - Tarpon",4,8,3,0,15
"Dickenson County",-,"502 - North Clintwood",13,22,7,0,42
"Dickenson County",-,"Ab - Central Absentee Precinct",9,8,9,0,26
"Dickenson County",-,Provisional,0,0,0,0,0
"Dinwiddie County",-,"101 - White Oak",32,24,8,0,64
"Dinwiddie County",-,"102 - Rocky Run",38,48,12,0,98
"Dinwiddie County",-,"103 - Church Road",42,79,22,0,143
"Dinwiddie County",-,"201 - Rohoic",21,24,5,0,50
"Dinwiddie County",-,"202 - Sutherland",67,84,22,0,173
"Dinwiddie County",-,"301 - Reams",24,30,6,0,60
"Dinwiddie County",-,"302 - New Hope",41,51,8,0,100
"Dinwiddie County",-,"303 - Little Zion",29,34,11,0,74
"Dinwiddie County",-,"401 - Dinwiddie",45,77,14,0,136
"Dinwiddie County",-,"402 - Mckenney",20,34,12,0,66
"Dinwiddie County",-,"403 - Cherry Hill",20,17,3,0,40
"Dinwiddie County",-,"501 - Edgehill",2,6,1,0,9
"Dinwiddie County",-,"502 - Chesdin",23,42,10,0,75
"Dinwiddie County",-,"Ab - Central Absentee Precinct",12,11,4,0,27
"Dinwiddie County",-,Provisional,0,0,0,0,0
"Emporia City",-,"101 - Precinct 1-1",4,11,2,0,17
"Emporia City",-,"201 - Precinct 2-1",1,0,0,0,1
"Emporia City",-,"301 - Precinct 3-1",15,16,5,0,36
"Emporia City",-,"401 - Precinct 4-1",15,17,2,0,34
"Emporia City",-,"501 - Precinct 5-1",0,0,0,0,0
"Emporia City",-,"601 - District 6",18,20,8,0,46
"Emporia City",-,"701 - District 7",5,10,2,0,17
"Emporia City",-,Provisional,0,0,0,0,0
"Essex County",-,"101 - Greater Tappahannock",48,54,14,0,116
"Essex County",-,"201 - North",35,32,13,0,80
"Essex County",-,"301 - South",73,84,11,0,168
"Essex County",-,"401 - Central",55,53,6,0,114
"Essex County",-,"Ab - Central Absentee Precinct",3,4,7,0,14
"Essex County",-,Provisional,0,0,0,0,0
"Fairfax County",-,"104 - Chapel (CD 11)",115,45,43,0,203
"Fairfax County",-,"105 - Fairview (CD 11)",163,62,65,0,290
"Fairfax County",-,"106 - Heritage (CD 11)",45,25,27,0,97
"Fairfax County",-,"108 - Kings Park (CD 11)",113,43,33,0,189
"Fairfax County",-,"109 - Little Run (CD 11)",59,22,16,0,97
"Fairfax County",-,"110 - North Springfield (CD 11)",109,84,45,0,238
"Fairfax County",-,"113 - Canterbury (CD 11)",163,44,52,0,259
"Fairfax County",-,"114 - Olde Creek (CD 11)",74,48,24,0,146
"Fairfax County",-,"115 - Ravensworth (CD 11)",77,26,29,0,132
"Fairfax County",-,"116 - Wakefield (CD 11)",78,41,26,0,145
"Fairfax County",-,"117 - Woodson (CD 11)",80,43,21,0,144
"Fairfax County",-,"118 - Lake Braddock (CD 11)",90,45,21,0,156
"Fairfax County",-,"119 - Laurel (CD 11)",143,83,38,0,264
"Fairfax County",-,"120 - Sideburn (CD 11)",125,72,71,0,268
"Fairfax County",-,"121 - Villa (CD 11)",70,31,19,0,120
"Fairfax County",-,"123 - Robinson (CD 11)",129,60,45,0,234
"Fairfax County",-,"125 - Signal Hill (CD 11)",97,57,31,0,185
"Fairfax County",-,"126 - Bonnie Brae (CD 11)",86,28,24,0,138
"Fairfax County",-,"127 - Burke Centre (CD 11)",125,52,36,0,213
"Fairfax County",-,"128 - Cardinal (CD 11)",62,41,26,0,129
"Fairfax County",-,"129 - Keene Mill (CD 11)",58,31,20,0,109
"Fairfax County",-,"130 - Terra Centre (CD 11)",112,22,26,0,160
"Fairfax County",-,"131 - Eagle View (CD 11)",89,35,25,0,149
"Fairfax County",-,"132 - Monument (CD 11)",43,17,21,0,81
"Fairfax County",-,"133 - Danbury (CD 11)",15,7,4,0,26
"Fairfax County",-,"134 - University (CD 11)",8,4,6,0,18
"Fairfax County",-,"201 - Armstrong (CD 11)",79,21,43,0,143
"Fairfax County",-,"202 - Flint Hill (CD 11)",112,67,43,0,222
"Fairfax County",-,"203 - Floris (CD 11)",111,36,36,0,183
"Fairfax County",-,"204 - Madison (CD 11)",22,6,5,0,33
"Fairfax County",-,"208 - Reston #1 (CD 11)",73,12,10,0,95
"Fairfax County",-,"209 - Reston #2 (CD 11)",59,13,13,0,85
"Fairfax County",-,"213 - Vienna #1 (CD 11)",107,47,29,0,183
"Fairfax County",-,"214 - Vienna #2 (CD 11)",73,34,21,0,128
"Fairfax County",-,"216 - Vienna #4 (CD 11)",39,14,13,0,66
"Fairfax County",-,"218 - Vienna #6 (CD 11)",63,17,14,0,94
"Fairfax County",-,"219 - Westbriar (CD 11)",98,44,33,0,175
"Fairfax County",-,"220 - Dogwood (CD 11)",80,30,23,0,133
"Fairfax County",-,"221 - Hunters Woods (CD 11)",91,50,24,0,165
"Fairfax County",-,"222 - Reston #3 (CD 11)",37,13,10,0,60
"Fairfax County",-,"223 - Glade (CD 11)",86,31,22,0,139
"Fairfax County",-,"224 - South Lakes (CD 11)",87,41,22,0,150
"Fairfax County",-,"225 - Hughes (CD 11)",55,26,11,0,92
"Fairfax County",-,"226 - Wolftrap (CD 11)",143,46,28,0,217
"Fairfax County",-,"227 - Sunrise Valley (CD 11)",69,31,18,0,118
"Fairfax County",-,"229 - Fox Mill (CD 10)",219,70,40,0,329
"Fairfax County",-,"233 - North Point (CD 11)",89,34,25,0,148
"Fairfax County",-,"234 - Aldrin (CD 11)",88,29,19,0,136
"Fairfax County",-,"235 - Frying Pan (CD 11)",51,21,15,0,87
"Fairfax County",-,"236 - Stuart (CD 11)",37,10,10,0,57
"Fairfax County",-,"237 - Mcnair (CD 11)",33,8,6,0,47
"Fairfax County",-,"238 - Cameron Glen (CD 11)",70,34,18,0,122
"Fairfax County",-,"240 - Colvin (CD 10)",96,33,33,0,162
"Fairfax County",-,"301 - Chain Bridge (CD 10)",116,37,31,0,184
"Fairfax County",-,"302 - Chesterbrook (CD 8)",138,33,47,0,218
"Fairfax County",-,"303 - Churchill (CD 10)",47,17,19,0,83
"Fairfax County",-,"304 - Cooper (CD 10)",84,28,29,0,141
"Fairfax County",-,"305 - El Nido (CD 8)",84,21,11,0,116
"Fairfax County",-,"306 - Great Falls (CD 10)",92,41,31,0,164
"Fairfax County",-,"307 - Haycock (CD 8)",81,35,29,0,145
"Fairfax County",-,"309 - Kenmore (CD 10)",143,46,28,0,217
"Fairfax County",-,"310 - Kirby (CD 8)",78,20,19,0,117
"Fairfax County",-,"311 - Langley (CD 10)",120,33,31,0,184
"Fairfax County",-,"312 - Longfellow (CD 8)",57,34,23,0,114
"Fairfax County",-,"314 - Mclean (CD 10)",69,20,43,0,132
"Fairfax County",-,"315 - Pimmit (CD 8)",69,37,24,0,130
"Fairfax County",-,"316 - Salona #1 (CD 8)",31,10,20,0,61
"Fairfax County",-,"317 - Westhampton (CD 8)",91,33,29,0,153
"Fairfax County",-,"318 - Westmoreland (CD 8)",51,24,14,0,89
"Fairfax County",-,"319 - Herndon #1 (CD 11)",108,56,27,0,191
"Fairfax County",-,"320 - Herndon #2 (CD 11)",89,42,27,0,158
"Fairfax County",-,"321 - Clearview (CD 10)",147,59,53,0,259
"Fairfax County",-,"322 - Forestville (CD 10)",134,39,52,0,225
"Fairfax County",-,"323 - Shouse (CD 10)",76,47,36,0,159
"Fairfax County",-,"324 - Herndon #3 (CD 11)",78,31,23,0,132
"Fairfax County",-,"325 - Hutchison (CD 11)",25,8,12,0,45
"Fairfax County",-,"327 - Sugarland (CD 10)",123,38,31,0,192
"Fairfax County",-,"328 - Hickory (CD 10)",115,48,30,0,193
"Fairfax County",-,"329 - Seneca (CD 10)",142,45,30,0,217
"Fairfax County",-,"331 - Spring Hill (CD 10)",131,62,28,0,221
"Fairfax County",-,"332 - Coates (CD 11)",30,10,13,0,53
"Fairfax County",-,"333 - Salona #2 (CD 8)",53,21,59,0,133
"Fairfax County",-,"401 - Bush Hill (CD 8)",133,43,33,0,209
"Fairfax County",-,"402 - Cameron (CD 8)",22,8,10,0,40
"Fairfax County",-,"403 - Forestdale (CD 8)",24,12,11,0,47
"Fairfax County",-,"404 - Franconia (CD 8)",54,29,22,0,105
"Fairfax County",-,"405 - Groveton (CD 8)",28,10,7,0,45
"Fairfax County",-,"406 - Hayfield (CD 8)",109,62,21,0,192
"Fairfax County",-,"408 - Mount Eagle (CD 8)",47,24,14,0,85
"Fairfax County",-,"409 - Pioneer (CD 8)",56,36,27,0,119
"Fairfax County",-,"410 - Rose Hill (CD 8)",105,56,38,0,199
"Fairfax County",-,"411 - Virginia Hills (CD 8)",65,34,15,0,114
"Fairfax County",-,"413 - Fairfield (CD 8)",9,8,10,0,27
"Fairfax County",-,"415 - Crestwood (CD 8)",59,33,23,0,115
"Fairfax County",-,"417 - Garfield (CD 8)",58,34,22,0,114
"Fairfax County",-,"418 - Lynbrook (CD 8)",39,18,14,0,71
"Fairfax County",-,"419 - Lane (CD 8)",42,30,18,0,90
"Fairfax County",-,"420 - Villages (CD 8)",94,47,26,0,167
"Fairfax County",-,"421 - Kingstowne (CD 8)",61,20,22,0,103
"Fairfax County",-,"422 - Van Dorn (CD 8)",66,31,22,0,119
"Fairfax County",-,"423 - Clermont (CD 8)",92,23,25,0,140
"Fairfax County",-,"424 - Huntley (CD 8)",95,49,18,0,162
"Fairfax County",-,"426 - Greenspring (CD 11)",117,85,74,0,276
"Fairfax County",-,"427 - Island Creek (CD 8)",57,22,17,0,96
"Fairfax County",-,"428 - Pinewood (CD 8)",39,14,11,0,64
"Fairfax County",-,"429 - Hybla Valley (CD 8)",23,12,8,0,43
"Fairfax County",-,"501 - Baileys (CD 8)",53,17,19,0,89
"Fairfax County",-,"502 - Barcroft (CD 11)",42,17,18,0,77
"Fairfax County",-,"503 - Belvedere (CD 11)",43,23,14,0,80
"Fairfax County",-,"504 - Bristow (CD 11)",40,21,17,0,78
"Fairfax County",-,"505 - Glen Forest (CD 8)",35,15,17,0,67
"Fairfax County",-,"506 - Holmes #1 (CD 8)",4,2,0,0,6
"Fairfax County",-,"507 - Lincolnia (CD 8)",65,34,25,0,124
"Fairfax County",-,"508 - Masonville (CD 11)",58,30,23,0,111
"Fairfax County",-,"509 - Plaza (CD 8)",16,15,9,0,40
"Fairfax County",-,"510 - Parklawn (CD 8)",44,28,20,0,92
"Fairfax County",-,"511 - Ravenwood (CD 11)",60,29,36,0,125
"Fairfax County",-,"512 - Sleepy Hollow (CD 11)",33,21,17,0,71
"Fairfax County",-,"513 - Saint Albans (CD 11)",54,29,13,0,96
"Fairfax County",-,"513 - Saint Albans (CD 8)",35,15,4,0,54
"Fairfax County",-,"514 - Crossroads (CD 8)",16,7,9,0,32
"Fairfax County",-,"515 - Westlawn (CD 8)",30,15,10,0,55
"Fairfax County",-,"516 - Weyanoke (CD 8)",48,29,18,0,95
"Fairfax County",-,"517 - Willston (CD 8)",25,10,5,0,40
"Fairfax County",-,"518 - Columbia (CD 11)",46,40,23,0,109
"Fairfax County",-,"519 - Hummer (CD 11)",62,18,11,0,91
"Fairfax County",-,"520 - Skyline (CD 8)",23,16,15,0,54
"Fairfax County",-,"521 - Brook Hill (CD 8)",50,32,16,0,98
"Fairfax County",-,"522 - Camelot (CD 11)",69,31,24,0,124
"Fairfax County",-,"523 - Poe (CD 8)",60,20,13,0,93
"Fairfax County",-,"525 - Walnut Hill (CD 8)",64,38,21,0,123
"Fairfax County",-,"526 - Bren Mar (CD 8)",61,15,23,0,99
"Fairfax County",-,"527 - Edsall (CD 8)",44,29,16,0,89
"Fairfax County",-,"528 - Ridgelea (CD 11)",51,18,23,0,92
"Fairfax County",-,"530 - Holmes #2 (CD 11)",23,8,12,0,43
"Fairfax County",-,"601 - Belle Haven (CD 8)",88,35,24,0,147
"Fairfax County",-,"602 - Belleview (CD 8)",65,26,31,0,122
"Fairfax County",-,"604 - Bucknell (CD 8)",73,33,20,0,126
"Fairfax County",-,"605 - Fort Hunt (CD 8)",122,61,33,0,216
"Fairfax County",-,"606 - Hollin Hall (CD 8)",143,49,31,0,223
"Fairfax County",-,"607 - Huntington (CD 8)",96,41,33,0,170
"Fairfax County",-,"608 - Kirkside (CD 8)",53,22,18,0,93
"Fairfax County",-,"609 - Marlan (CD 8)",96,51,32,0,179
"Fairfax County",-,"610 - Sherwood (CD 8)",75,15,13,0,103
"Fairfax County",-,"611 - Stratford (CD 8)",158,58,45,0,261
"Fairfax County",-,"612 - Waynewood (CD 8)",82,26,24,0,132
"Fairfax County",-,"613 - Westgate (CD 8)",252,83,97,0,432
"Fairfax County",-,"614 - Riverside (CD 8)",130,51,48,0,229
"Fairfax County",-,"615 - Woodley (CD 8)",103,46,27,0,176
"Fairfax County",-,"616 - Gunston (CD 8)",108,60,35,0,203
"Fairfax County",-,"617 - Lorton (CD 8)",25,16,6,0,47
"Fairfax County",-,"618 - Newington (CD 11)",126,55,47,0,228
"Fairfax County",-,"619 - Belvoir (CD 8)",66,24,17,0,107
"Fairfax County",-,"621 - Grosvenor (CD 8)",33,22,12,0,67
"Fairfax County",-,"622 - Lorton Station (CD 8)",42,19,12,0,73
"Fairfax County",-,"623 - Alban (CD 8)",75,24,19,0,118
"Fairfax County",-,"625 - Lorton Center (CD 8)",46,24,22,0,92
"Fairfax County",-,"626 - Saratoga (CD 8)",113,42,28,0,183
"Fairfax County",-,"627 - Woodlawn (CD 8)",49,29,19,0,97
"Fairfax County",-,"628 - Laurel Hill (CD 11)",38,18,16,0,72
"Fairfax County",-,"629 - South County (CD 11)",99,57,42,0,198
"Fairfax County",-,"701 - Blake (CD 11)",102,41,25,0,168
"Fairfax County",-,"703 - Fort Buffalo (CD 8)",28,10,13,0,51
"Fairfax County",-,"704 - Freedom Hill (CD 11)",69,38,14,0,121
"Fairfax County",-,"705 - Graham - Greenway (CD 8)",70,27,18,0,115
"Fairfax County",-,"707 - Mantua (CD 11)",93,37,25,0,155
"Fairfax County",-,"708 - Marshall (CD 8)",86,40,22,0,148
"Fairfax County",-,"709 - Mosby (CD 11)",49,28,20,0,97
"Fairfax County",-,"710 - Pine Spring (CD 8)",39,16,17,0,72
"Fairfax County",-,"711 - Price (CD 11)",75,22,19,0,116
"Fairfax County",-,"712 - Shreve (CD 8)",54,20,19,0,93
"Fairfax County",-,"713 - Timber Lane (CD 8)",41,29,15,0,85
"Fairfax County",-,"714 - Walker (CD 11)",83,35,33,0,151
"Fairfax County",-,"717 - Woodburn (CD 11)",60,27,20,0,107
"Fairfax County",-,"718 - Pine Ridge (CD 11)",54,22,18,0,94
"Fairfax County",-,"720 - Thoreau (CD 11)",91,53,21,0,165
"Fairfax County",-,"721 - Merrifield (CD 11)",62,22,19,0,103
"Fairfax County",-,"726 - Magarity (CD 8)",65,34,28,0,127
"Fairfax County",-,"727 - Oakton (CD 11)",87,50,28,0,165
"Fairfax County",-,"729 - Nottoway (CD 11)",80,37,23,0,140
"Fairfax County",-,"730 - Penderbrook (CD 11)",91,31,26,0,148
"Fairfax County",-,"731 - Tysons (CD 11)",32,12,13,0,57
"Fairfax County",-,"732 - Oak Marr (CD 11)",130,47,26,0,203
"Fairfax County",-,"733 - Kilmer (CD 11)",64,35,11,0,110
"Fairfax County",-,"734 - Hunters Branch (CD 11)",45,13,4,0,62
"Fairfax County",-,"735 - Rotonda (CD 11)",39,20,6,0,65
"Fairfax County",-,"801 - Burke (CD 11)",103,54,48,0,205
"Fairfax County",-,"802 - Cedar Lake (CD 11)",24,7,10,0,41
"Fairfax County",-,"803 - Clifton (CD 10)",220,109,76,0,405
"Fairfax County",-,"804 - Colchester (CD 10)",93,52,16,0,161
"Fairfax County",-,"805 - Fairfax Station (CD 10)",121,44,13,0,178
"Fairfax County",-,"806 - Sydenstricker (CD 11)",109,63,36,0,208
"Fairfax County",-,"807 - Hunt Valley (CD 11)",104,44,21,0,169
"Fairfax County",-,"811 - Pohick (CD 11)",52,17,24,0,93
"Fairfax County",-,"812 - Valley (CD 11)",102,48,28,0,178
"Fairfax County",-,"815 - Woodyard (CD 10)",141,58,48,0,247
"Fairfax County",-,"824 - Orange (CD 11)",162,85,89,0,336
"Fairfax County",-,"825 - Cherry Run (CD 11)",96,69,32,0,197
"Fairfax County",-,"827 - Irving (CD 11)",99,45,33,0,177
"Fairfax County",-,"833 - White Oaks (CD 11)",75,86,22,0,183
"Fairfax County",-,"838 - Sangster (CD 10)",110,45,33,0,188
"Fairfax County",-,"839 - Silverbrook (CD 10)",147,81,51,0,279
"Fairfax County",-,"840 - West Springfield (CD 11)",102,42,35,0,179
"Fairfax County",-,"841 - Popes Head (CD 10)",93,55,19,0,167
"Fairfax County",-,"842 - Parkway (CD 11)",93,54,36,0,183
"Fairfax County",-,"843 - Fair Lakes (CD 11)",92,44,24,0,160
"Fairfax County",-,"844 - Centerpointe (CD 11)",44,16,16,0,76
"Fairfax County",-,"845 - Fountainhead (CD 10)",241,88,50,0,379
"Fairfax County",-,"846 - Greenbriar East (CD 11)",79,44,20,0,143
"Fairfax County",-,"847 - Greenbriar West (CD 10)",105,36,21,0,162
"Fairfax County",-,"848 - Fair Oaks (CD 11)",69,29,13,0,111
"Fairfax County",-,"849 - Newgate North (CD 10)",71,33,14,0,118
"Fairfax County",-,"850 - South Run (CD 10)",154,84,37,0,275
"Fairfax County",-,"851 - Willow Springs (CD 11)",97,45,28,0,170
"Fairfax County",-,"854 - Newgate South (CD 10)",177,44,29,0,250
"Fairfax County",-,"901 - Centre Ridge (CD 11)",56,23,21,0,100
"Fairfax County",-,"902 - Brookfield (CD 10)",102,61,32,0,195
"Fairfax County",-,"903 - Cub Run (CD 10)",129,65,42,0,236
"Fairfax County",-,"904 - Stonecroft (CD 10)",57,23,20,0,100
"Fairfax County",-,"905 - Franklin (CD 10)",49,20,15,0,84
"Fairfax County",-,"908 - Hidden Meadow (CD 10)",94,19,23,0,136
"Fairfax County",-,"909 - Oak Hill (CD 10)",90,32,19,0,141
"Fairfax County",-,"910 - London Towne (CD 11)",63,31,14,0,108
"Fairfax County",-,"911 - Navy (CD 10)",95,33,33,0,161
"Fairfax County",-,"913 - Rocky Run (CD 10)",134,48,46,0,228
"Fairfax County",-,"914 - Vale (CD 10)",107,35,20,0,162
"Fairfax County",-,"915 - Virginia Run (CD 10)",141,43,40,0,224
"Fairfax County",-,"916 - Waples Mill (CD 10)",209,67,39,0,315
"Fairfax County",-,"917 - Stone North (CD 10)",45,29,16,0,90
"Fairfax County",-,"918 - Centreville (CD 11)",68,31,33,0,132
"Fairfax County",-,"919 - Green Trails (CD 11)",68,43,25,0,136
"Fairfax County",-,"920 - Chantilly (CD 10)",92,30,15,0,137
"Fairfax County",-,"921 - Deer Park (CD 10)",131,59,43,0,233
"Fairfax County",-,"923 - Bull Run (CD 10)",95,44,31,0,170
"Fairfax County",-,"924 - Spindle (CD 11)",27,15,7,0,49
"Fairfax County",-,"925 - Old Mill (CD 10)",39,16,19,0,74
"Fairfax County",-,"926 - Powell (CD 11)",69,31,13,0,113
"Fairfax County",-,"927 - Armfield (CD 10)",48,15,15,0,78
"Fairfax County",-,"928 - Poplar Tree (CD 10)",86,43,32,0,161
"Fairfax County",-,"929 - Difficult Run (CD 10)",38,16,11,0,65
"Fairfax County",-,"930 - Lees Corner (CD 10)",97,33,20,0,150
"Fairfax County",-,"931 - Carson (CD 10)",57,19,21,0,97
"Fairfax County",-,"932 - Stone South (CD 10)",31,13,7,0,51
"Fairfax County",-,"933 - Compton (CD 11)",19,7,5,0,31
"Fairfax County",-,"Ab - Central Absentee Precinct (CD 10)",271,141,71,0,483
"Fairfax County",-,"Ab - Central Absentee Precinct (CD 11)",406,210,157,0,773
"Fairfax County",-,"Ab - Central Absentee Precinct (CD 8)",281,149,87,0,517
"Fairfax County",-,"Provisional (CD 10)",0,3,0,0,3
"Fairfax County",-,"Provisional (CD 11)",1,3,0,0,4
"Fairfax County",-,"Provisional (CD 8)",1,4,1,0,6
"Fairfax City",-,"1 - One",73,18,29,0,120
"Fairfax City",-,"2 - Two",98,43,34,0,175
"Fairfax City",-,"3 - Three",113,45,30,0,188
"Fairfax City",-,"4 - Four",90,47,31,0,168
"Fairfax City",-,"5 - Five",80,29,17,0,126
"Fairfax City",-,"6 - Six",85,26,27,0,138
"Fairfax City",-,"Ab - Central Absentee Precinct",29,15,9,0,53
"Fairfax City",-,Provisional,1,0,0,0,1
"Falls Church City",-,"1 - First Ward",76,33,16,0,125
"Falls Church City",-,"2 - Second Ward",55,25,19,0,99
"Falls Church City",-,"3 - Third Ward",68,34,22,0,124
"Falls Church City",-,"Ab - Central Absentee Precinct",15,7,4,0,26
"Falls Church City",-,Provisional,0,0,0,0,0
"Fauquier County",-,"101 - Kettle Run (CD 5)",97,34,15,0,146
"Fauquier County",-,"102 - Catlett (CD 1)",197,53,57,0,307
"Fauquier County",-,"103 - Casanova (CD 5)",98,30,24,0,152
"Fauquier County",-,"104 - Lois (CD 1)",93,65,17,0,175
"Fauquier County",-,"105 - Opal (CD 5)",94,32,13,0,139
"Fauquier County",-,"106 - Baldwin Ridge (CD 5)",120,18,15,0,153
"Fauquier County",-,"201 - Courthouse (CD 5)",191,59,16,0,266
"Fauquier County",-,"202 - Airlie (CD 5)",194,44,31,0,269
"Fauquier County",-,"203 - Warrenton (CD 5)",177,52,25,0,254
"Fauquier County",-,"301 - Morrisville (CD 1)",115,66,28,0,209
"Fauquier County",-,"302 - Remington (CD 5)",200,46,30,0,276
"Fauquier County",-,"303 - Bealeton (CD 1)",148,54,36,0,238
"Fauquier County",-,"401 - Marshall (CD 5)",223,42,34,0,299
"Fauquier County",-,"402 - Leeds (CD 5)",214,38,13,0,265
"Fauquier County",-,"403 - Waterloo (CD 5)",270,50,29,0,349
"Fauquier County",-,"404 - Springs Valley (CD 5)",126,27,22,0,175
"Fauquier County",-,"501 - The Plains (CD 5)",192,31,13,0,236
"Fauquier County",-,"502 - New Baltimore (CD 5)",204,42,18,0,264
"Fauquier County",-,"503 - Broad Run (CD 5)",230,44,27,0,301
"Fauquier County",-,"504 - Vint Hill (CD 5)",280,46,51,0,377
"Fauquier County",-,"Ab - Central Absentee Precinct (CD 1)",12,4,2,0,18
"Fauquier County",-,"Ab - Central Absentee Precinct (CD 5)",120,34,15,0,169
"Fauquier County",-,"Provisional (CD 1)",0,0,0,0,0
"Fauquier County",-,"Provisional (CD 5)",0,0,0,0,0
"Floyd County",-,"101 - Locust Grove",42,83,28,0,153
"Floyd County",-,"201 - Little River",38,68,17,0,123
"Floyd County",-,"301 - Courthouse",20,56,24,0,100
"Floyd County",-,"401 - Burks Fork",30,61,18,0,109
"Floyd County",-,"501 - Indian Valley",29,71,20,0,120
"Floyd County",-,"Ab - Central Absentee Precinct",10,16,4,0,30
"Floyd County",-,Provisional,0,0,0,0,0
"Fluvanna County",-,"101 - Palmyra",45,155,28,0,228
"Fluvanna County",-,"201 - Columbia",37,151,23,0,211
"Fluvanna County",-,"301 - Fork Union",56,139,22,0,217
"Fluvanna County",-,"401 - Cunningham",84,209,38,0,331
"Fluvanna County",-,"501 - Rivanna",77,270,51,0,398
"Fluvanna County",-,"Ab - Central Absentee Precinct",13,40,12,0,65
"Fluvanna County",-,Provisional,0,0,0,0,0
"Franklin County",-,"102 - Burnt Chimney",64,117,37,0,218
"Franklin County",-,"103 - Scruggs",158,256,113,0,527
"Franklin County",-,"201 - Glade Hill",33,72,23,0,128
"Franklin County",-,"202 - Penhook",48,102,33,0,183
"Franklin County",-,"203 - Hodgesville",5,5,3,0,13
"Franklin County",-,"204 - Dudley",33,55,18,0,106
"Franklin County",-,"301 - Snow Creek",14,37,12,0,63
"Franklin County",-,"302 - Fork Mountain",24,30,4,0,58
"Franklin County",-,"303 - Sontag",20,31,7,0,58
"Franklin County",-,"304 - Dickinson",13,21,8,0,42
"Franklin County",-,"401 - Henry",37,55,10,0,102
"Franklin County",-,"402 - Ferrum",26,41,11,0,78
"Franklin County",-,"403 - Endicott",12,49,11,0,72
"Franklin County",-,"501 - Waidsboro",28,50,8,0,86
"Franklin County",-,"502 - Callaway",35,79,24,0,138
"Franklin County",-,"503 - Bowmans",13,30,8,0,51
"Franklin County",-,"504 - Gogginsville",19,63,17,0,99
"Franklin County",-,"601 - Boones Mill",43,86,17,0,146
"Franklin County",-,"602 - Bonbrook",36,84,21,0,141
"Franklin County",-,"603 - Coopers Cove",39,94,20,0,153
"Franklin County",-,"701 - Rocky Mount East",35,83,24,0,142
"Franklin County",-,"702 - Rocky Mount West",25,53,16,0,94
"Franklin County",-,"703 - Rocky Mount South",19,37,20,0,76
"Franklin County",-,"Ab - Central Absentee Precinct",19,21,7,0,47
"Franklin County",-,Provisional,0,0,0,0,0
"Franklin City",-,"101 - Precinct 1-1",64,78,33,0,175
"Franklin City",-,"201 - Precinct 2-1",46,59,26,0,131
"Franklin City",-,"301 - Precinct 3-1",2,0,0,0,2
"Franklin City",-,"401 - Precinct 4-1",3,5,1,0,9
"Franklin City",-,"501 - Precinct 5-1",0,1,0,0,1
"Franklin City",-,"601 - Precinct 6-1",38,36,16,0,90
"Franklin City",-,"Ab - Central Absentee Precinct",11,6,3,0,20
"Franklin City",-,Provisional,0,0,0,0,0
"Frederick County",-,"101 - Russells",175,44,12,0,231
"Frederick County",-,"102 - Gore",133,39,11,0,183
"Frederick County",-,"103 - Kernstown",221,44,25,0,290
"Frederick County",-,"104 - Cedar Creek",101,22,13,0,136
"Frederick County",-,"201 - Gainesborough",109,36,21,0,166
"Frederick County",-,"202 - Albin",141,55,14,0,210
"Frederick County",-,"203 - Redland",157,46,13,0,216
"Frederick County",-,"204 - Nain",168,69,22,0,259
"Frederick County",-,"301 - Clear Brook",99,24,11,0,134
"Frederick County",-,"302 - Neff's Town",122,34,14,0,170
"Frederick County",-,"303 - White Hall",227,64,19,0,310
"Frederick County",-,"401 - Carpers Valley",215,35,13,0,263
"Frederick County",-,"402 - Shenandoah",70,28,16,0,114
"Frederick County",-,"403 - Parkin's Mill",115,38,15,0,168
"Frederick County",-,"404 - Armel",126,29,20,0,175
"Frederick County",-,"501 - Stephens City",163,35,18,0,216
"Frederick County",-,"502 - Newtown",160,40,20,0,220
"Frederick County",-,"503 - Canterburg",207,46,20,0,273
"Frederick County",-,"601 - Millbrook",100,22,8,0,130
"Frederick County",-,"602 - Ash Hollow",91,34,11,0,136
"Frederick County",-,"603 - Greenwood",200,55,22,0,277
"Frederick County",-,"Ab - Central Absentee Precinct",98,21,10,0,129
"Frederick County",-,Provisional,1,0,0,0,1
"Fredericksburg City",-,"101 - Precinct 1 - District One",78,168,18,0,264
"Fredericksburg City",-,"201 - Precinct 1 - District Two",60,198,31,0,289
"Fredericksburg City",-,"301 - Precinct 1 - District Three",56,167,20,0,243
"Fredericksburg City",-,"401 - Precinct 1 - District Four",20,78,10,0,108
"Fredericksburg City",-,"402 - Precinct 2 - District Four",27,39,5,0,71
"Fredericksburg City",-,"Ab - Central Absentee Precinct",7,36,4,0,47
"Fredericksburg City",-,Provisional,0,0,0,0,0
"Galax City",-,"1 - East",26,68,26,0,120
"Galax City",-,"2 - North",11,43,13,0,67
"Galax City",-,"3 - South",9,26,9,0,44
"Galax City",-,"Ab - Central Absentee Precinct",5,7,4,0,16
"Galax City",-,Provisional,0,0,0,0,0
"Giles County",-,"101 - Glen Lyn",6,4,3,0,13
"Giles County",-,"102 - Rich Creek",21,25,12,0,58
"Giles County",-,"103 - Narrows",41,63,23,0,127
"Giles County",-,"201 - Pearisburg",78,92,40,0,210
"Giles County",-,"202 - Staffordsville",7,17,7,0,31
"Giles County",-,"203 - White Gate",9,12,6,0,27
"Giles County",-,"301 - Eggleston",28,31,5,0,64
"Giles County",-,"302 - Pembroke",45,62,25,0,132
"Giles County",-,"303 - Newport",55,29,10,0,94
"Giles County",-,"Ab - Central Absentee Precinct",20,11,2,0,33
"Giles County",-,Provisional,0,0,0,0,0
"Gloucester County",-,"101 - Harcum",72,92,34,0,198
"Gloucester County",-,"102 - Salem",78,71,20,0,169
"Gloucester County",-,"103 - Peasley",54,60,17,0,131
"Gloucester County",-,"201 - Courthouse",79,112,32,0,223
"Gloucester County",-,"202 - Botetourt",120,126,28,0,274
"Gloucester County",-,"301 - White Marsh",111,97,22,0,230
"Gloucester County",-,"302 - Roanes",98,127,38,0,263
"Gloucester County",-,"401 - Hayes",103,106,21,0,230
"Gloucester County",-,"402 - Sarahs Creek",91,87,23,0,201
"Gloucester County",-,"501 - Achilles",164,188,52,0,404
"Gloucester County",-,"502 - Walker",126,114,22,0,262
"Gloucester County",-,"Ab - Central Absentee Precinct",22,24,14,0,60
"Gloucester County",-,Provisional,0,0,0,0,0
"Goochland County",-,"101 - Fife",41,79,13,0,133
"Goochland County",-,"102 - Hadensville",67,126,22,0,215
"Goochland County",-,"201 - Three Square",24,26,7,0,57
"Goochland County",-,"202 - Sandy Hook",87,156,20,0,263
"Goochland County",-,"301 - Goochland Court House 1",94,137,34,0,265
"Goochland County",-,"302 - Goochland Court House 2",45,43,13,0,101
"Goochland County",-,"401 - Shallow Well",95,104,33,0,232
"Goochland County",-,"402 - Centerville",207,239,73,0,519
"Goochland County",-,"501 - Manakin",204,188,76,0,468
"Goochland County",-,"502 - Blair Road",131,150,47,0,328
"Goochland County",-,"Ab - Central Absentee Precinct",40,55,11,0,106
"Goochland County",-,Provisional,0,0,0,0,0
"Grayson County",-,"101 - Bridle Creek",3,12,4,0,19
"Grayson County",-,"102 - Flatridge",1,8,0,0,9
"Grayson County",-,"103 - Grant",5,12,2,0,19
"Grayson County",-,"104 - Mouth Of Wilson",5,7,4,0,16
"Grayson County",-,"105 - Mount Rogers",2,11,3,0,16
"Grayson County",-,"106 - Rugby",1,9,5,0,15
"Grayson County",-,"107 - Troutdale",0,6,3,0,9
"Grayson County",-,"108 - Comers Rock",2,7,4,0,13
"Grayson County",-,"202 - Elk Creek",11,26,5,0,42
"Grayson County",-,"203 - Independence",33,55,26,0,114
"Grayson County",-,"301 - Baywood",11,42,11,0,64
"Grayson County",-,"302 - Fairview",15,40,15,0,70
"Grayson County",-,"401 - Fries",5,19,4,0,28
"Grayson County",-,"402 - Providence",16,34,15,0,65
"Grayson County",-,"403 - Oldtown",3,20,6,0,29
"Grayson County",-,"Ab - Central Absentee Precinct",3,10,6,0,19
"Grayson County",-,Provisional,0,0,0,0,0
"Greene County",-,"101 - Dyke",13,56,19,0,88
"Greene County",-,"102 - Swift Run",20,54,18,0,92
"Greene County",-,"201 - Ruckersville",53,98,51,0,202
"Greene County",-,"301 - Stanardsville",53,139,51,0,243
"Greene County",-,"401 - Midway",39,187,65,0,291
"Greene County",-,"Ab - Central Absentee Precinct",12,31,5,0,48
"Greene County",-,Provisional,0,0,0,0,0
"Greensville County",-,"101 - Precinct 1-a",5,11,3,0,19
"Greensville County",-,"102 - Precinct 1-b",2,16,4,0,22
"Greensville County",-,"103 - Precinct 1-c",6,3,0,0,9
"Greensville County",-,"201 - Precinct 2-a",16,12,4,0,32
"Greensville County",-,"202 - Precinct 2-b",19,34,4,0,57
"Greensville County",-,"302 - Precinct 3-a",21,26,5,0,52
"Greensville County",-,"401 - Precinct 4-a",15,9,5,0,29
"Greensville County",-,"402 - Precinct 4-b",15,16,5,0,36
"Greensville County",-,"403 - Precinct 4-c",6,15,2,0,23
"Greensville County",-,Provisional,0,0,0,0,0
"Halifax County",-,"101 - Childrey",16,35,13,0,64
"Halifax County",-,"102 - Liberty",7,31,6,0,44
"Halifax County",-,"103 - Republican Grove",13,35,15,0,63
"Halifax County",-,"201 - Clays Mill",15,31,12,0,58
"Halifax County",-,"202 - Crossroads",7,41,15,0,63
"Halifax County",-,"203 - Clover",4,29,8,0,41
"Halifax County",-,"302 - Meadville",10,7,3,0,20
"Halifax County",-,"304 - Vernon Hill",17,35,9,0,61
"Halifax County",-,"305 - Sinai",16,21,11,0,48
"Halifax County",-,"401 - Courthouse",22,50,9,0,81
"Halifax County",-,"403 - Center",29,72,25,0,126
"Halifax County",-,"502 - Dan River",37,79,31,0,147
"Halifax County",-,"503 - Scottsburg",26,40,27,0,93
"Halifax County",-,"601 - Black Walnut",14,29,15,0,58
"Halifax County",-,"603 - Mt Carmel",31,48,20,0,99
"Halifax County",-,"605 - Union",7,24,6,0,37
"Halifax County",-,"701 - Hyco",22,52,18,0,92
"Halifax County",-,"702 - Midway",18,64,18,0,100
"Halifax County",-,"703 - Virgilina",7,35,11,0,53
"Halifax County",-,"801 - South Boston",10,21,8,0,39
"Halifax County",-,"802 - South Boston West",9,14,5,0,28
"Halifax County",-,"Ab - Central Absentee Precinct",13,35,13,0,61
"Halifax County",-,Provisional,0,0,0,0,0
"Hampton City",-,"101 - Aberdeen (CD 3)",10,24,9,0,43
"Hampton City",-,"102 - Bassette (CD 3)",5,6,3,0,14
"Hampton City",-,"103 - City Hall (CD 3)",15,9,8,0,32
"Hampton City",-,"104 - Cooper (CD 3)",17,28,10,0,55
"Hampton City",-,"105 - East Hampton (CD 3)",29,31,7,0,67
"Hampton City",-,"106 - Armstrong (CD 3)",78,71,25,0,174
"Hampton City",-,"107 - Lindsay (CD 3)",24,30,9,0,63
"Hampton City",-,"108 - Thomas (CD 3)",26,24,9,0,59
"Hampton City",-,"109 - Phenix (CD 3)",12,8,2,0,22
"Hampton City",-,"110 - Phoebus (CD 2)",27,16,5,0,48
"Hampton City",-,"111 - Hampton Library (CD 3)",37,28,19,0,84
"Hampton City",-,"112 - Smith (CD 3)",53,47,27,0,127
"Hampton City",-,"115 - Wythe (CD 3)",78,48,18,0,144
"Hampton City",-,"116 - Jones (CD 3)",24,17,9,0,50
"Hampton City",-,"117 - Kecoughtan (CD 3)",30,35,9,1,75
"Hampton City",-,"118 - Mallory (CD 3)",20,22,10,0,52
"Hampton City",-,"201 - Booker (CD 2)",107,103,45,0,255
"Hampton City",-,"202 - Bryan (CD 2)",98,89,36,0,223
"Hampton City",-,"203 - Burbank (CD 2)",64,65,21,0,150
"Hampton City",-,"204 - Forrest (CD 3)",46,48,19,0,113
"Hampton City",-,"205 - Asbury (CD 2)",165,190,63,0,418
"Hampton City",-,"208 - Kraft (CD 3)",88,102,35,0,225
"Hampton City",-,"209 - Langley (CD 2)",31,67,25,0,123
"Hampton City",-,"210 - Machen (CD 3)",64,64,14,0,142
"Hampton City",-,"212 - Bethel (CD 3)",68,67,23,0,158
"Hampton City",-,"213 - Phillips (CD 2)",152,134,66,0,352
"Hampton City",-,"214 - Tucker Capps (CD 3)",74,79,19,0,172
"Hampton City",-,"215 - Tyler (CD 2)",0,0,0,0,0
"Hampton City",-,"215 - Tyler (CD 3)",10,8,2,0,20
"Hampton City",-,"216 - Sandy Bottom (CD 3)",36,38,11,0,85
"Hampton City",-,"217 - Syms (CD 3)",43,46,17,0,106
"Hampton City",-,"Ab - Central Absentee Precinct (CD 2)",9,10,2,0,21
"Hampton City",-,"Ab - Central Absentee Precinct (CD 3)",11,9,6,0,26
"Hampton City",-,"Provisional (CD 2)",0,0,0,0,0
"Hampton City",-,"Provisional (CD 3)",1,2,0,0,3
"Hanover County",-,"101 - Ashland",75,69,26,0,170
"Hanover County",-,"104 - Sliding Hill",112,87,27,0,226
"Hanover County",-,"105 - Berkley",54,41,11,0,106
"Hanover County",-,"106 - Kersey Creek",66,63,15,0,144
"Hanover County",-,"107 - Chickahominy",90,65,31,0,186
"Hanover County",-,"201 - Beaverdam",141,155,45,0,341
"Hanover County",-,"202 - Blunts",82,64,18,0,164
"Hanover County",-,"203 - Wilmington Parish",145,133,24,0,302
"Hanover County",-,"206 - Courthouse",82,77,14,0,173
"Hanover County",-,"208 - Oak Knoll",98,84,21,0,203
"Hanover County",-,"209 - West Hanover",23,33,9,0,65
"Hanover County",-,"210 - Oak Hill",42,45,9,0,96
"Hanover County",-,"301 - Clay",102,131,81,0,314
"Hanover County",-,"303 - Shady Grove",124,154,49,0,327
"Hanover County",-,"304 - Atlee",214,209,45,0,468
"Hanover County",-,"305 - Cool Spring",111,93,31,0,235
"Hanover County",-,"401 - Battlefield",155,146,56,0,357
"Hanover County",-,"403 - Cold Harbor",157,147,51,0,355
"Hanover County",-,"404 - Black Creek",178,225,48,0,451
"Hanover County",-,"405 - Pebble Creek",81,94,17,0,192
"Hanover County",-,"406 - Beaverdam Creek",24,32,5,0,61
"Hanover County",-,"502 - Rural Point",122,128,52,0,302
"Hanover County",-,"503 - Newman",71,83,22,0,176
"Hanover County",-,"504 - Studley",123,92,30,0,245
"Hanover County",-,"505 - Totopotomoy",95,85,23,0,203
"Hanover County",-,"506 - Georgetown",95,107,28,0,230
"Hanover County",-,"507 - Laurel Meadow",107,96,35,0,238
"Hanover County",-,"601 - Village",228,210,76,0,514
"Hanover County",-,"602 - Lee Davis",31,128,175,0,334
"Hanover County",-,"603 - Mechanicsville",73,70,18,0,161
"Hanover County",-,"604 - Hanover Grove",102,99,29,0,230
"Hanover County",-,"701 - Farrington",130,137,44,0,311
"Hanover County",-,"702 - Montpelier",119,102,16,0,237
"Hanover County",-,"703 - Rockville",122,119,40,0,281
"Hanover County",-,"704 - Elmont",100,142,43,0,285
"Hanover County",-,"705 - South Anna",88,57,20,0,165
"Hanover County",-,"Ab - Central Absentee Precinct",90,91,30,0,211
"Hanover County",-,Provisional,1,2,0,0,3
"Harrisonburg City",-,"101 - Northeast",54,37,28,0,119
"Harrisonburg City",-,"102 - East Central",36,18,15,0,69
"Harrisonburg City",-,"103 - Southeast",49,24,28,0,101
"Harrisonburg City",-,"104 - East",69,22,29,0,120
"Harrisonburg City",-,"105 - South East Central",8,5,3,0,16
"Harrisonburg City",-,"201 - Northwest",65,38,35,0,138
"Harrisonburg City",-,"202 - Southwest",51,45,40,0,136
"Harrisonburg City",-,"203 - West",52,49,30,0,131
"Harrisonburg City",-,"Ab - Central Absentee Precinct",21,15,12,0,48
"Harrisonburg City",-,Provisional,0,0,0,0,0
"Henrico County",-,"101 - Coalpit (CD 7)",128,121,35,0,284
"Henrico County",-,"102 - Dumbarton (CD 7)",67,73,25,0,165
"Henrico County",-,"103 - Glen Allen (CD 7)",256,203,82,1,542
"Henrico County",-,"104 - Glenside (CD 7)",35,34,6,0,75
"Henrico County",-,"105 - Greendale (CD 7)",111,106,28,0,245
"Henrico County",-,"106 - Hermitage (CD 7)",90,113,30,0,233
"Henrico County",-,"108 - Hungary Creek (CD 7)",207,203,55,0,465
"Henrico County",-,"109 - Hunton (CD 7)",41,103,16,0,160
"Henrico County",-,"110 - Johnson (CD 7)",27,37,10,0,74
"Henrico County",-,"111 - Lakeside (CD 7)",129,156,68,0,353
"Henrico County",-,"112 - Longan (CD 7)",102,159,56,0,317
"Henrico County",-,"113 - Maude Trevvett (CD 7)",98,72,16,0,186
"Henrico County",-,"114 - Monument Hills (CD 7)",57,41,16,0,114
"Henrico County",-,"115 - Staples Mill (CD 7)",211,237,98,0,546
"Henrico County",-,"117 - Westwood (CD 7)",95,84,25,0,204
"Henrico County",-,"201 - Adams (CD 4)",2,11,0,0,13
"Henrico County",-,"202 - Azalea (CD 7)",3,9,0,0,12
"Henrico County",-,"203 - Belmont (CD 7)",52,62,20,0,134
"Henrico County",-,"204 - Brookland (CD 7)",26,20,6,0,52
"Henrico County",-,"205 - Canterbury (CD 7)",74,88,42,0,204
"Henrico County",-,"206 - Central Gardens (CD 4)",1,1,3,0,5
"Henrico County",-,"207 - Chamberlayne (CD 7)",71,50,16,0,137
"Henrico County",-,"208 - Fairfield (CD 4)",3,6,2,0,11
"Henrico County",-,"209 - Glen Lea (CD 4)",13,18,4,0,35
"Henrico County",-,"210 - Greenwood (CD 7)",18,20,5,0,43
"Henrico County",-,"211 - Highland Gardens (CD 4)",3,2,0,0,5
"Henrico County",-,"212 - Hollybrook (CD 7)",23,21,4,0,48
"Henrico County",-,"213 - Hungary (CD 7)",17,25,8,0,50
"Henrico County",-,"214 - Longdale (CD 7)",38,41,14,0,93
"Henrico County",-,"215 - Maplewood (CD 4)",9,7,2,0,18
"Henrico County",-,"216 - Moody (CD 7)",50,46,18,0,114
"Henrico County",-,"217 - Mountain (CD 7)",29,31,11,0,71
"Henrico County",-,"218 - Oakview (CD 7)",4,2,4,0,10
"Henrico County",-,"219 - Randolph (CD 7)",11,3,2,0,16
"Henrico County",-,"220 - Ratcliffe (CD 4)",10,10,1,0,21
"Henrico County",-,"221 - Stratford Hall (CD 7)",13,11,5,0,29
"Henrico County",-,"222 - Wilder (CD 7)",25,29,8,0,62
"Henrico County",-,"223 - Yellow Tavern (CD 7)",87,100,20,0,207
"Henrico County",-,"224 - Essex Village (CD 4)",0,0,0,0,0
"Henrico County",-,"301 - Causeway (CD 7)",130,64,26,0,220
"Henrico County",-,"302 - Cedarfield (CD 7)",177,151,53,0,381
"Henrico County",-,"303 - Innsbrook (CD 7)",129,108,64,0,301
"Henrico County",-,"304 - Jackson Davis (CD 7)",76,77,28,0,181
"Henrico County",-,"305 - Nuckols Farm (CD 7)",184,164,93,0,441
"Henrico County",-,"306 - Pocahontas (CD 7)",101,69,41,0,211
"Henrico County",-,"307 - Ridge (CD 7)",79,83,22,0,184
"Henrico County",-,"308 - Rivers Edge (CD 7)",243,198,80,0,521
"Henrico County",-,"309 - Sadler (CD 7)",187,140,92,0,419
"Henrico County",-,"310 - Shady Grove (CD 7)",243,177,91,0,511
"Henrico County",-,"311 - Short Pump (CD 7)",179,148,82,0,409
"Henrico County",-,"312 - Springfield (CD 7)",63,38,11,0,112
"Henrico County",-,"313 - Stoney Run (CD 7)",174,131,70,0,375
"Henrico County",-,"314 - Three Chopt (CD 7)",134,106,30,0,270
"Henrico County",-,"315 - Tucker (CD 7)",39,44,17,0,100
"Henrico County",-,"401 - Quioccasin (CD 7)",128,100,18,0,246
"Henrico County",-,"402 - Crestview (CD 7)",67,65,16,0,148
"Henrico County",-,"403 - Derbyshire (CD 7)",122,128,50,0,300
"Henrico County",-,"404 - Freeman (CD 7)",71,55,20,0,146
"Henrico County",-,"405 - Gayton (CD 7)",259,185,49,0,493
"Henrico County",-,"406 - Godwin (CD 7)",139,115,32,0,286
"Henrico County",-,"407 - Lakewood (CD 7)",108,129,35,0,272
"Henrico County",-,"408 - Lauderdale (CD 7)",101,129,23,0,253
"Henrico County",-,"409 - Maybeury (CD 7)",179,101,44,0,324
"Henrico County",-,"410 - Mooreland (CD 7)",141,98,39,0,278
"Henrico County",-,"411 - Pemberton (CD 7)",89,76,21,0,186
"Henrico County",-,"412 - Pinchbeck (CD 7)",132,113,34,0,279
"Henrico County",-,"413 - Ridgefield (CD 7)",172,136,54,0,362
"Henrico County",-,"414 - Rollingwood (CD 7)",87,46,24,0,157
"Henrico County",-,"415 - Skipwith (CD 7)",61,50,18,0,129
"Henrico County",-,"416 - Spottswood (CD 7)",50,49,12,0,111
"Henrico County",-,"417 - Tuckahoe (CD 7)",198,137,145,0,480
"Henrico County",-,"418 - Welborne (CD 7)",76,56,17,0,149
"Henrico County",-,"419 - West End (CD 7)",177,103,54,0,334
"Henrico County",-,"501 - Antioch (CD 4)",106,100,33,0,239
"Henrico County",-,"502 - Cedar Fork (CD 4)",8,14,3,0,25
"Henrico County",-,"503 - Chickahominy (CD 4)",83,104,38,0,225
"Henrico County",-,"504 - Donahoe (CD 4)",24,44,3,0,71
"Henrico County",-,"505 - Dorey (CD 4)",97,94,7,0,198
"Henrico County",-,"506 - Eanes (CD 4)",26,19,11,0,56
"Henrico County",-,"507 - Elko (CD 4)",46,46,10,0,102
"Henrico County",-,"508 - Highland Springs (CD 4)",13,22,6,0,41
"Henrico County",-,"509 - Laburnum (CD 4)",39,31,9,0,79
"Henrico County",-,"510 - Mehfoud (CD 4)",38,34,5,0,77
"Henrico County",-,"511 - Montrose (CD 4)",28,24,7,0,59
"Henrico County",-,"512 - Nine Mile (CD 4)",24,36,5,0,65
"Henrico County",-,"513 - Pleasants (CD 4)",20,25,3,0,48
"Henrico County",-,"514 - Rolfe (CD 4)",14,30,5,0,49
"Henrico County",-,"515 - Sandston (CD 4)",90,98,24,0,212
"Henrico County",-,"516 - Sullivans (CD 4)",43,61,8,0,112
"Henrico County",-,"517 - Town Hall (CD 4)",41,39,8,0,88
"Henrico County",-,"518 - Whitlocks (CD 4)",78,69,28,0,175
"Henrico County",-,"AB - Central Absentee Precinct (CD 4)",19,21,12,0,52
"Henrico County",-,"Ab - Central Absentee Precinct (CD 7)",216,196,75,0,487
"Henrico County",-,"Provisional (CD 4)",1,0,0,0,1
"Henrico County",-,"Provisional (CD 7)",2,2,2,0,6
"Henry County",-,"101 - Bassett Number Two (CD 9)",10,12,6,0,28
"Henry County",-,"102 - Gunville (CD 9)",18,27,21,0,66
"Henry County",-,"103 - Scott's Tanyard (CD 9)",32,78,18,0,128
"Henry County",-,"201 - Fieldale (CD 9)",14,14,7,0,35
"Henry County",-,"202 - Horsepasture #1 (CD 9)",17,28,12,0,57
"Henry County",-,"203 - Horsepasture #2 (CD 9)",9,13,4,0,26
"Henry County",-,"204 - Spencer (CD 9)",19,36,12,0,67
"Henry County",-,"302 - Axton (CD 5)",17,25,5,0,47
"Henry County",-,"303 - Irisburg (CD 5)",19,42,11,0,72
"Henry County",-,"304 - Mount Olivet (CD 5)",25,55,20,0,100
"Henry County",-,"304 - Mount Olivet (CD 9)",0,0,0,0,0
"Henry County",-,"305 - Mountain Valley (CD 5)",4,39,6,0,49
"Henry County",-,"401 - Collinsville Number 1 (CD 9)",19,46,6,0,71
"Henry County",-,"402 - Daniels Creek (CD 9)",10,38,9,0,57
"Henry County",-,"404 - Collinsville Number 2 (CD 9)",31,70,21,0,122
"Henry County",-,"405 - Mountain View (CD 5)",15,31,6,0,52
"Henry County",-,"501 - Bassett Number One (CD 9)",10,25,9,0,44
"Henry County",-,"502 - Figsboro (CD 9)",27,44,8,0,79
"Henry County",-,"503 - Stanleytown (CD 9)",40,68,19,0,127
"Henry County",-,"504 - Oak Level (CD 9)",7,32,5,0,44
"Henry County",-,"505 - Dyers Store (CD 5)",3,2,0,0,5
"Henry County",-,"505 - Dyers Store (CD 9)",15,20,11,0,46
"Henry County",-,"601 - Fontaine (CD 9)",33,53,12,0,98
"Henry County",-,"602 - Hillcrest (CD 9)",5,21,3,0,29
"Henry County",-,"603 - Ridgeway #1 (CD 5)",38,42,22,0,102
"Henry County",-,"604 - Ridgeway #2 (CD 9)",29,44,15,0,88
"Henry County",-,"Ab - Central Absentee Precinct (CD 5)",4,16,0,0,20
"Henry County",-,"Ab - Central Absentee Precinct (CD 9)",11,23,13,0,47
"Henry County",-,"Provisional (CD 5)",0,0,0,0,0
"Henry County",-,"Provisional (CD 9)",0,1,0,0,1
"Highland County",-,"1 - Monterey",23,24,17,0,64
"Highland County",-,"3 - Wilsons Mill",5,3,5,0,13
"Highland County",-,"5 - Blue Grass",11,16,10,0,37
"Highland County",-,"7 - Mill Gap",4,12,7,0,23
"Highland County",-,"8 - Mcdowell",11,11,14,0,36
"Highland County",-,"10 - Headwaters",1,9,6,0,16
"Highland County",-,Provisional,0,0,0,0,0
"Hopewell City",-,"101 - Ward One",39,38,21,0,98
"Hopewell City",-,"201 - Ward Two",3,10,0,0,13
"Hopewell City",-,"301 - Ward Three",68,101,42,0,211
"Hopewell City",-,"401 - Ward Four",58,67,27,0,152
"Hopewell City",-,"501 - Ward Five",43,46,28,0,117
"Hopewell City",-,"601 - Ward Six",6,10,5,0,21
"Hopewell City",-,"701 - Ward Seven",19,36,14,0,69
"Hopewell City",-,"Ab - Central Absentee Precinct",9,14,7,0,30
"Hopewell City",-,Provisional,0,0,0,0,0
"Isle of Wight County",-,"101 - Smithfield",199,186,74,0,459
"Isle of Wight County",-,"102 - Cypress Creek",149,169,57,0,375
"Isle of Wight County",-,"201 - Bartlett",173,183,75,0,431
"Isle of Wight County",-,"202 - Carrollton",158,154,82,0,394
"Isle of Wight County",-,"301 - Rushmere",77,89,30,0,196
"Isle of Wight County",-,"302 - Pons",74,57,26,0,157
"Isle of Wight County",-,"401 - Courthouse",63,44,23,0,130
"Isle of Wight County",-,"402 - Windsor",125,124,45,0,294
"Isle of Wight County",-,"403 - Longview",72,88,30,0,190
"Isle of Wight County",-,"501 - Walters",86,102,44,0,232
"Isle of Wight County",-,"502 - Camps Mill",17,29,4,0,50
"Isle of Wight County",-,"503 - Carrsville",31,33,16,0,80
"Isle of Wight County",-,"504 - Zuni",82,96,46,0,224
"Isle of Wight County",-,"505 - Raynor",34,26,11,0,71
"Isle of Wight County",-,"Ab - Central Absentee Precinct",27,34,13,0,74
"Isle of Wight County",-,Provisional,5,0,0,0,5
"James City County",-,"101 - Berkeley A",179,133,39,0,351
"James City County",-,"102 - Berkeley B",82,80,40,0,202
"James City County",-,"103 - Berkeley C",282,269,77,0,628
"James City County",-,"104- Berkeley D",47,37,13,0,97
"James City County",-,"201 - Jamestown A",36,39,12,0,87
"James City County",-,"202 - Jamestown B",94,87,36,0,217
"James City County",-,"203 - Jamestown C",129,123,58,0,310
"James City County",-,"204 - Jamestown D",235,236,58,0,529
"James City County",-,"301 - Powhatan A",165,213,74,0,452
"James City County",-,"302 - Powhatan B",33,28,10,0,71
"James City County",-,"303 - Powhatan C",44,66,38,0,148
"James City County",-,"304 - Powhatan D",103,109,32,0,244
"James City County",-,"401 - Stonehouse A",114,136,42,0,292
"James City County",-,"402 - Stonehouse B",256,254,71,0,581
"James City County",-,"403 - Stonehouse C",116,182,37,0,335
"James City County",-,"501 - Roberts A",23,34,11,0,68
"James City County",-,"502 - Roberts B",228,218,69,0,515
"James City County",-,"503 - Roberts C",13,6,2,0,21
"James City County",-,"504 - Roberts D",165,142,62,0,369
"James City County",-,"Ab - Central Absentee Precinct",98,102,53,0,253
"James City County",-,Provisional,2,2,1,0,5
"King and Queen County",-,"101 - Owenton",11,14,6,0,31
"King and Queen County",-,"201 - Clarks",41,49,7,0,97
"King and Queen County",-,"301 - Shacklefords",33,33,11,0,77
"King and Queen County",-,"401 - Courthouse",36,31,11,0,78
"King and Queen County",-,"501 - Oldmill",35,46,15,0,96
"King and Queen County",-,"Ab - Central Absentee Precinct",11,6,1,0,18
"King and Queen County",-,Provisional,0,0,0,0,0
"King George County",-,"101 - Courthouse",91,84,28,0,203
"King George County",-,"102 - Passapatanzy",41,64,12,0,117
"King George County",-,"201 - Monroe",104,239,32,0,375
"King George County",-,"301 - Dahlgren",86,115,36,0,237
"King George County",-,"401 - Shiloh",131,163,41,0,335
"King George County",-,"Ab - Central Absentee Precinct",17,35,5,0,57
"King George County",-,Provisional,0,0,0,0,0
"King William County",-,"101 - West Point",73,94,36,0,203
"King William County",-,"201 - Sweet Hall",28,53,8,0,89
"King William County",-,"202 - Courthouse",50,49,14,0,113
"King William County",-,"301 - Aylett",94,90,29,0,213
"King William County",-,"401 - Manquin",70,99,30,0,199
"King William County",-,"501 - Mangohick",76,105,21,0,202
"King William County",-,"Ab - Central Absentee Precinct",12,5,4,0,21
"King William County",-,Provisional,0,0,0,0,0
"Lancaster County",-,"101 - Precinct 1-1",98,89,33,0,220
"Lancaster County",-,"201 - Precinct 2-1",38,49,8,0,95
"Lancaster County",-,"301 - Precinct 3-1",75,47,11,0,133
"Lancaster County",-,"302 - Precinct 3-2",41,23,11,0,75
"Lancaster County",-,"401 - Precinct 4-1",48,36,15,0,99
"Lancaster County",-,"501 - Precinct 5-1",105,109,21,0,235
"Lancaster County",-,"Ab - Central Absentee Precinct",25,26,4,0,55
"Lancaster County",-,Provisional,0,0,0,0,0
"Lee County",-,"101 - Elydale",3,8,11,0,22
"Lee County",-,"102 - Ewing",16,13,5,0,34
"Lee County",-,"103 - Rose Hill",4,10,11,0,25
"Lee County",-,"201 - Blackwater",3,2,1,0,6
"Lee County",-,"202 - Flatwoods",11,12,8,0,31
"Lee County",-,"203 - Jonesville",30,16,12,0,58
"Lee County",-,"301 - Ben Hur",20,12,23,0,55
"Lee County",-,"302 - Woodway",10,10,5,0,25
"Lee County",-,"401 - Stickleyville",3,1,9,0,13
"Lee County",-,"402 - Jasper",8,2,4,0,14
"Lee County",-,"403 - Seminary",9,15,9,0,33
"Lee County",-,"404 - Dryden",7,10,5,0,22
"Lee County",-,"501 - Saint Charles",5,1,2,0,8
"Lee County",-,"502 - Pennington",14,12,21,0,47
"Lee County",-,"503 - Robbins Chapel",2,5,0,0,7
"Lee County",-,"504 - Keokee",5,6,6,0,17
"Lee County",-,"Ab - Central Absentee Precinct",7,3,1,0,11
"Lee County",-,Provisional,0,0,0,0,0
"Lexington City",-,"1 - Lexington",53,70,35,0,158
"Lexington City",-,"Ab - Central Absentee Precinct",9,15,1,0,25
"Lexington City",-,Provisional,0,0,0,0,0
"Loudoun County",-,"107 - Little River",85,25,15,0,125
"Loudoun County",-,"108 - Mercer",79,18,14,0,111
"Loudoun County",-,"112 - Freedom",62,10,5,0,77
"Loudoun County",-,"114 - Dulles South",41,18,20,0,79
"Loudoun County",-,"117 - Carter",12,7,4,0,23
"Loudoun County",-,"118 - Moorefield",52,13,8,0,73
"Loudoun County",-,"119 - Arcola",74,26,27,0,127
"Loudoun County",-,"120 - Lunsford",68,12,5,0,85
"Loudoun County",-,"121 - Town Hall",76,18,16,0,110
"Loudoun County",-,"122 - Hutchison Farm",71,26,16,0,113
"Loudoun County",-,"123 - Cardinal Ridge",53,22,11,0,86
"Loudoun County",-,"124 - Liberty",40,8,11,0,59
"Loudoun County",-,"125 - Rock Ridge",28,5,7,0,40
"Loudoun County",-,"207 - River Bend",68,38,14,0,120
"Loudoun County",-,"208 - Algonkian",70,30,25,0,125
"Loudoun County",-,"209 - Potomac Falls",95,31,38,0,164
"Loudoun County",-,"210 - Cascades",63,39,14,0,116
"Loudoun County",-,"213 - Countryside",35,15,6,0,56
"Loudoun County",-,"214 - Sugarland North",158,51,43,0,252
"Loudoun County",-,"215 - Sugarland South",122,42,35,0,199
"Loudoun County",-,"216 - Lowes Island",89,29,18,0,136
"Loudoun County",-,"217 - South Bank",91,22,19,0,132
"Loudoun County",-,"218 - University Center",49,17,7,0,73
"Loudoun County",-,"219 - Galilee Church",63,19,21,0,103
"Loudoun County",-,"301 - Purcellville",145,67,25,0,237
"Loudoun County",-,"302 - Round Hill",169,50,22,0,241
"Loudoun County",-,"303 - Hillsboro",151,48,25,0,224
"Loudoun County",-,"305 - Philomont",81,36,8,0,125
"Loudoun County",-,"307 - Middleburg",85,18,6,0,109
"Loudoun County",-,"308 - St Louis",79,16,11,0,106
"Loudoun County",-,"309 - Aldie",108,15,3,0,126
"Loudoun County",-,"310 - Mountain View",136,39,22,0,197
"Loudoun County",-,"311 - Round Hill Elementary",126,38,28,0,192
"Loudoun County",-,"312 - Briar Woods",29,19,10,0,58
"Loudoun County",-,"313 - Pinebrook",118,59,29,0,206
"Loudoun County",-,"314 - Legacy",60,22,16,0,98
"Loudoun County",-,"315 - Firehouse",72,13,5,0,90
"Loudoun County",-,"316 - Creighton's Corner",68,39,14,0,121
"Loudoun County",-,"318 - Madison's Trust",83,23,12,0,118
"Loudoun County",-,"401 - West Lovettsville",169,53,33,0,255
"Loudoun County",-,"402 - Waterford",147,45,27,0,219
"Loudoun County",-,"403 - Lucketts",103,44,25,0,172
"Loudoun County",-,"407 - Harper Park",47,28,12,0,87
"Loudoun County",-,"408 - Evergreen",58,21,10,0,89
"Loudoun County",-,"409 - Clarkes Gap",180,46,30,0,256
"Loudoun County",-,"411 - East Lovettsville",133,47,20,0,200
"Loudoun County",-,"413 - Tuscarora",5,0,0,0,5
"Loudoun County",-,"414 - Red Rock",34,22,8,0,64
"Loudoun County",-,"416 - Hamilton",213,62,26,0,301
"Loudoun County",-,"419 - J. L. Simpson",113,39,12,0,164
"Loudoun County",-,"420 - River Creek",124,54,26,0,204
"Loudoun County",-,"421 - Between The Hills",22,5,5,0,32
"Loudoun County",-,"501 - West Leesburg",117,36,22,0,175
"Loudoun County",-,"502 - East Leesburg",51,29,8,0,88
"Loudoun County",-,"503 - Dry Mill",69,29,8,0,106
"Loudoun County",-,"504 - Smarts Mill",116,31,21,0,168
"Loudoun County",-,"505 - Cool Spring",95,50,36,0,181
"Loudoun County",-,"506 - Brandon Park",42,17,12,0,71
"Loudoun County",-,"507 - Greenway",64,16,10,0,90
"Loudoun County",-,"508 - Balls Bluff",91,18,13,0,122
"Loudoun County",-,"509 - Tolbert",38,19,16,0,73
"Loudoun County",-,"510 - Heritage",79,35,14,0,128
"Loudoun County",-,"615 - Hillside",84,27,22,0,133
"Loudoun County",-,"616 - Eagle Ridge",70,17,13,0,100
"Loudoun County",-,"617 - Oak Grove",10,4,10,0,24
"Loudoun County",-,"619 - Ridgetop",9,12,5,0,26
"Loudoun County",-,"620 - Russell Branch",97,49,22,0,168
"Loudoun County",-,"621 - Dominion Trail",80,40,24,0,144
"Loudoun County",-,"622 - Farmwell Station",96,34,23,0,153
"Loudoun County",-,"623 - Weller",110,49,26,0,185
"Loudoun County",-,"625 - Mill Run",36,18,8,0,62
"Loudoun County",-,"626 - Ashby Ponds",123,47,43,0,213
"Loudoun County",-,"627 - Ashbrook",47,19,9,0,75
"Loudoun County",-,"628 - Moorefield Station",32,14,11,0,57
"Loudoun County",-,"629 - Discovery",23,2,5,0,30
"Loudoun County",-,"701 - Sully",69,35,19,0,123
"Loudoun County",-,"702 - Park View",57,38,22,0,117
"Loudoun County",-,"703 - Rolling Ridge",31,16,19,0,66
"Loudoun County",-,"705 - Forest Grove",93,48,25,0,166
"Loudoun County",-,"707 - Claude Moore Park",28,6,12,0,46
"Loudoun County",-,"708 - Seneca",81,30,17,0,128
"Loudoun County",-,"709 - Mirror Ridge",48,24,19,0,91
"Loudoun County",-,"710 - Sterling",54,26,26,0,106
"Loudoun County",-,"808 - Stone Bridge",119,28,15,0,162
"Loudoun County",-,"810 - Cedar Lane",73,24,19,0,116
"Loudoun County",-,"813 - Seldens Landing",36,17,16,0,69
"Loudoun County",-,"814 - Newton - Lee",123,37,18,0,178
"Loudoun County",-,"815 - Belmont Ridge",135,39,26,0,200
"Loudoun County",-,"817 - Sanders Corner",104,71,26,0,201
"Loudoun County",-,"818 - Broad Run",60,24,13,0,97
"Loudoun County",-,"819 - Heritage Church",77,26,18,0,121
"Loudoun County",-,"820 - Belmont Station",69,17,18,0,104
"Loudoun County",-,"822 - Riverside",40,9,9,0,58
"Loudoun County",-,"Ab - Central Absentee Precinct",258,95,38,0,391
"Loudoun County",-,Provisional,3,0,1,0,4
"Louisa County",-,"101 - Zion",60,212,31,0,303
"Louisa County",-,"102 - Mechanicsville",19,114,16,0,149
"Louisa County",-,"201 - Louisa #1",43,205,25,0,273
"Louisa County",-,"202 - Louisa #2",43,147,15,0,205
"Louisa County",-,"301 - Patrick Henry No 1",48,175,17,0,240
"Louisa County",-,"302 - Patrick Henry #2",14,74,6,0,94
"Louisa County",-,"401 - Mineral",95,282,23,0,400
"Louisa County",-,"402 - Yanceyville",17,57,6,0,80
"Louisa County",-,"501 - Fredericks Hall",20,60,12,0,92
"Louisa County",-,"502 - Cuckoo",45,133,19,0,197
"Louisa County",-,"503 - Elk Creek",65,116,17,0,198
"Louisa County",-,"601 - Bumpass",58,140,20,0,218
"Louisa County",-,"602 - Locust Creek",78,183,30,0,291
"Louisa County",-,"701 - Sheltons Mill",97,130,26,0,253
"Louisa County",-,"702 - South Anna",55,110,33,0,198
"Louisa County",-,"Ab - Central Absentee Precinct",39,116,12,0,167
"Louisa County",-,Provisional,0,0,0,0,0
"Lunenburg County",-,"101 - Plymouth",26,34,9,0,69
"Lunenburg County",-,"201 - Browns Store",18,33,14,0,65
"Lunenburg County",-,"301 - Rosebud",19,24,4,0,47
"Lunenburg County",-,"302 - Flat Rock",17,22,7,0,46
"Lunenburg County",-,"401 - Arrowhead Gun Club",10,25,6,0,41
"Lunenburg County",-,"402 - Pleasant Grove",12,23,10,0,45
"Lunenburg County",-,"501 - Reedy Creek",7,23,4,0,34
"Lunenburg County",-,"502 - Peoples Community Center",13,7,3,0,23
"Lunenburg County",-,"601 - Hounds Creek",13,19,7,0,39
"Lunenburg County",-,"701 - Meherrin Fire Department",8,18,3,0,29
"Lunenburg County",-,"702 - Victoria Public Library",17,27,3,0,47
"Lunenburg County",-,"Ab - Central Absentee Precinct",6,5,2,0,13
"Lunenburg County",-,Provisional,0,0,0,0,0
"Lynchburg City",-,"101 - First Ward First Precinct",132,183,73,0,388
"Lynchburg City",-,"102 - First Ward Second Precinct",237,239,128,0,604
"Lynchburg City",-,"103 - First Ward Third Precinct",176,155,73,0,404
"Lynchburg City",-,"104 - First Ward Fourth Precinct",45,48,28,0,121
"Lynchburg City",-,"105 - First Ward Fifth Precinct",85,83,42,0,210
"Lynchburg City",-,"201 - Second Ward First Precinct",64,44,20,0,128
"Lynchburg City",-,"202 - Second Ward Second Precinct",26,23,26,0,75
"Lynchburg City",-,"203 - Second Ward Third Precinct",10,17,4,0,31
"Lynchburg City",-,"204 - Second Ward Fourth Precinct",17,54,11,0,82
"Lynchburg City",-,"301 - Third Ward First Precinct",48,49,28,0,125
"Lynchburg City",-,"302 - Third Ward Second Precinct",14,8,5,0,27
"Lynchburg City",-,"303 - Third Ward Third Precinct",53,99,36,0,188
"Lynchburg City",-,"304 - Third Ward Fourth Precinct",70,80,49,0,199
"Lynchburg City",-,"305 - Third Ward Fifth Precinct",131,217,85,0,433
"Lynchburg City",-,"401 - Fourth Ward First Precinct",212,278,121,0,611
"Lynchburg City",-,"402 - Fourth Ward Second Precinct",74,125,50,0,249
"Lynchburg City",-,"403 - Fourth Ward Third Precinct",123,152,73,0,348
"Lynchburg City",-,"404 - Fourth Ward Fourth Precinct",171,181,81,0,433
"Lynchburg City",-,"Ab - Central Absentee Precinct",69,75,37,0,181
"Lynchburg City",-,Provisional,3,1,0,0,4
"Madison County",-,"1 - Oak Park",23,40,11,0,74
"Madison County",-,"2 - Radiant",22,60,24,0,106
"Madison County",-,"3 - Rochelle",20,35,12,0,67
"Madison County",-,"4 - Graves Mill",6,9,5,0,20
"Madison County",-,"5 - Madison",31,87,33,0,151
"Madison County",-,"6 - Wolftown",19,38,13,0,70
"Madison County",-,"7 - Brightwood",31,105,25,0,161
"Madison County",-,"8 - Criglersville",22,37,16,0,75
"Madison County",-,"9 - Etlan",10,30,8,0,48
"Madison County",-,"Ab - Central Absentee Precinct",10,23,3,0,36
"Madison County",-,Provisional,0,0,0,0,0
"Manassas City",-,"1 - Dean",60,50,32,0,142
"Manassas City",-,"2 - Weems",141,66,47,0,254
"Manassas City",-,"3 - Metz",140,47,52,0,239
"Manassas City",-,"4 - Haydon",134,64,69,0,267
"Manassas City",-,"5 - Baldwin",88,53,37,0,178
"Manassas City",-,"6 - Round",145,94,53,0,292
"Manassas City",-,"Ab - Central Absentee Precinct",53,41,15,0,109
"Manassas City",-,Provisional,0,0,0,0,0
"Manassas Park City",-,"1 - Precinct One",48,10,21,0,79
"Manassas Park City",-,"2 - Precinct Two",49,29,29,0,107
"Manassas Park City",-,"3 - Precinct Three",59,25,12,0,96
"Manassas Park City",-,"Ab - Central Absentee Precinct",14,4,3,0,21
"Manassas Park City",-,Provisional,0,0,0,0,0
"Martinsville City",-,"1 - Precinct #1",2,2,1,0,5
"Martinsville City",-,"2 - Precinct #2",23,36,6,0,65
"Martinsville City",-,"3 - Precinct #3",4,21,5,0,30
"Martinsville City",-,"4 - Precinct #4",13,32,5,0,50
"Martinsville City",-,"5 - Precinct #5",60,84,23,0,167
"Martinsville City",-,"6 - Precinct #6",0,0,0,0,0
"Martinsville City",-,"Ab - Central Absentee Precinct",6,10,3,0,19
"Martinsville City",-,Provisional,0,0,0,0,0
"Mathews County",-,"1 - Chesapeake",77,69,27,0,173
"Mathews County",-,"2 - Westville",97,89,37,0,223
"Mathews County",-,"3 - Piankatank",113,85,30,0,228
"Mathews County",-,"Ab - Central Absentee Precinct",14,12,3,0,29
"Mathews County",-,Provisional,0,0,0,0,0
"Mecklenburg County",-,"101 - Wrights Store",12,19,7,0,38
"Mecklenburg County",-,"102 - Pearsons Store",8,20,4,0,32
"Mecklenburg County",-,"103 - South Clarksville",15,21,12,0,48
"Mecklenburg County",-,"201 - Boydton",9,10,6,0,25
"Mecklenburg County",-,"202 - Bluestone Senior High School",5,7,2,0,14
"Mecklenburg County",-,"203 - Chase City Vfw Post",7,11,2,0,20
"Mecklenburg County",-,"301 - Bracey",28,41,29,0,98
"Mecklenburg County",-,"302 - Lacrosse",14,12,12,0,38
"Mecklenburg County",-,"401 - American Legion Hall",8,13,16,0,37
"Mecklenburg County",-,"402 - Park View Middle School",3,3,3,0,9
"Mecklenburg County",-,"501 - South Hill",34,73,38,0,145
"Mecklenburg County",-,"601 - Baskerville",4,11,10,0,25
"Mecklenburg County",-,"602 - Union Level",11,13,12,0,36
"Mecklenburg County",-,"603 - Smith Crossroads",6,14,4,0,24
"Mecklenburg County",-,"604 - Lake Gaston",12,10,6,0,28
"Mecklenburg County",-,"701 - Chase City",15,46,12,0,73
"Mecklenburg County",-,"702 - Sunshine",18,14,11,0,43
"Mecklenburg County",-,"801 - Finchley",2,8,2,0,12
"Mecklenburg County",-,"802 - Bluestone",33,39,18,0,90
"Mecklenburg County",-,"803 - Chase City Elementary School",12,24,11,0,47
"Mecklenburg County",-,"901 - Averett",6,7,12,0,25
"Mecklenburg County",-,"902 - Buffalo Springs",9,16,12,0,37
"Mecklenburg County",-,"903 - Clarksville",56,61,34,0,151
"Mecklenburg County",-,"Ab - Central Absentee Precinct",10,7,3,0,20
"Mecklenburg County",-,Provisional,0,1,0,0,1
"Middlesex County",-,"101 - Saluda",19,15,5,0,39
"Middlesex County",-,"102 - Urbanna",51,50,20,0,121
"Middlesex County",-,"201 - New Market",117,101,33,0,251
"Middlesex County",-,"302 - Church View",32,50,12,0,94
"Middlesex County",-,"401- Harmony Village",42,64,16,0,122
"Middlesex County",-,"501 - Wilton",82,74,32,0,188
"Middlesex County",-,"Ab - Central Absentee Precinct",16,13,3,0,32
"Middlesex County",-,Provisional,0,0,0,0,0
"Montgomery County",-,"101 - Precinct A-1",61,87,23,0,171
"Montgomery County",-,"102 - Precinct A-2",19,29,19,0,67
"Montgomery County",-,"103 - Precinct A-3",58,55,27,0,140
"Montgomery County",-,"201 - Precinct B-1",6,3,2,0,11
"Montgomery County",-,"202 - Precinct B-2",41,75,25,0,141
"Montgomery County",-,"203 - Precinct B-3",34,51,15,0,100
"Montgomery County",-,"204 - Precinct B-4",70,90,14,0,174
"Montgomery County",-,"301 - Precinct C-1",39,70,6,0,115
"Montgomery County",-,"302 - Precinct C-2",47,89,20,0,156
"Montgomery County",-,"303 - Precinct C-3",22,44,6,0,72
"Montgomery County",-,"304 - Precinct C-4",29,60,13,0,102
"Montgomery County",-,"401 - Precinct D-1",38,32,22,0,92
"Montgomery County",-,"402 - Precinct D-2",43,83,10,0,136
"Montgomery County",-,"403 - Precinct D-3",23,48,15,0,86
"Montgomery County",-,"404 - Precinct D-4",23,41,10,0,74
"Montgomery County",-,"405 - Precinct D-5",34,60,21,0,115
"Montgomery County",-,"501 - Precinct E-1",39,47,27,0,113
"Montgomery County",-,"502 - Precinct E-2",29,39,13,0,81
"Montgomery County",-,"503 - Precinct E-3",1,0,1,0,2
"Montgomery County",-,"601 - Precinct F-1",48,26,15,0,89
"Montgomery County",-,"602 - Precinct F-2",23,30,12,0,65
"Montgomery County",-,"603 - Precinct F-3",0,1,2,0,3
"Montgomery County",-,"701 - Precinct G-1",48,50,33,0,131
"Montgomery County",-,"702 - Precinct G-2",26,13,5,0,44
"Montgomery County",-,"Ab - Central Absentee Precinct",32,29,15,0,76
"Montgomery County",-,Provisional,1,0,0,0,1
"Nelson County",-,"101 - Rockfish",43,72,31,0,146
"Nelson County",-,"201 - Lovingston",31,43,21,0,95
"Nelson County",-,"202 - Schuyler",12,27,12,0,51
"Nelson County",-,"301 - Shipman",29,45,10,0,84
"Nelson County",-,"302 - Gladstone",5,11,0,0,16
"Nelson County",-,"401 - Roseland",43,102,31,0,176
"Nelson County",-,"402 - Montebello",12,8,4,0,24
"Nelson County",-,"501 - Faber",20,29,8,0,57
"Nelson County",-,"502 - Nellysford",63,75,38,0,176
"Nelson County",-,"Ab - Central Absentee Precinct",6,5,3,0,14
"Nelson County",-,Provisional,1,0,1,0,2
"New Kent County",-,"102 - Tunstall",34,40,10,0,84
"New Kent County",-,"103 - Southern Branch",111,111,27,6,255
"New Kent County",-,"201 - Quinton",105,127,37,0,269
"New Kent County",-,"202 - Kentwood",65,90,14,0,169
"New Kent County",-,"301 - Watkins",59,58,11,0,128
"New Kent County",-,"302 - Cumberland",58,59,16,0,133
"New Kent County",-,"401 - Providence Forge",102,109,29,0,240
"New Kent County",-,"403 - Mountcastle",40,33,9,1,83
"New Kent County",-,"501 - Eltham",40,41,24,0,105
"New Kent County",-,"502 - Chickahominy River",77,90,32,0,199
"New Kent County",-,"Ab - Central Absentee Precinct",16,15,8,0,39
"New Kent County",-,Provisional,0,0,0,0,0
"Newport News City",-,"101 - Denbigh (CD 3)",44,38,23,0,105
"Newport News City",-,"102 - Epes (CD 3)",37,38,18,0,93
"Newport News City",-,"103 - Jenkins (CD 3)",69,58,21,0,148
"Newport News City",-,"104 - Mcintosh (CD 3)",32,16,14,0,62
"Newport News City",-,"105 - Oyster Point (CD 3)",18,26,8,0,52
"Newport News City",-,"106 - Reservoir (CD 3)",71,64,18,0,153
"Newport News City",-,"107 - Richneck (CD 3)",83,67,24,0,174
"Newport News City",-,"108 - Lee Hall (CD 3)",30,42,16,0,88
"Newport News City",-,"109 - Windsor (CD 3)",41,40,23,0,104
"Newport News City",-,"110 - Greenwood (CD 3)",31,27,15,0,73
"Newport News City",-,"201 - Bland (CD 3)",9,9,2,0,20
"Newport News City",-,"202 - Boulevard (CD 3)",74,84,38,0,196
"Newport News City",-,"203 - Charles (CD 3)",117,130,56,0,303
"Newport News City",-,"204 - Wellesley (CD 3)",56,35,19,0,110
"Newport News City",-,"205 - Deep Creek (CD 3)",120,107,102,0,329
"Newport News City",-,"208 - Hidenwood (CD 3)",111,83,50,0,244
"Newport News City",-,"209 - Hilton (CD 3)",81,82,45,0,208
"Newport News City",-,"210 - Nelson (CD 3)",126,127,75,0,328
"Newport News City",-,"211 - Palmer (CD 3)",66,50,22,0,138
"Newport News City",-,"212 - Riverside (CD 3)",99,70,49,0,218
"Newport News City",-,"213 - Sanford (CD 3)",61,55,29,0,145
"Newport News City",-,"215 - Warwick (CD 3)",41,42,30,0,113
"Newport News City",-,"216 - Yates (CD 3)",68,67,36,0,171
"Newport News City",-,"217 - Riverview (CD 3)",85,102,64,0,251
"Newport News City",-,"218 - Kiln Creek (CD 3)",141,119,47,0,307
"Newport News City",-,"219 - Deer Park (CD 3)",56,57,27,0,140
"Newport News City",-,"302 - Briarfield (CD 3)",19,14,5,0,38
"Newport News City",-,"303 - Carver (CD 3)",8,14,6,0,28
"Newport News City",-,"304 - Chestnut (CD 3)",1,2,0,0,3
"Newport News City",-,"305 - Downtown (CD 3)",8,3,2,0,13
"Newport News City",-,"306 - Dunbar (CD 3)",1,0,1,0,2
"Newport News City",-,"307 - Huntington (CD 3)",1,0,1,0,2
"Newport News City",-,"308 - Jefferson (CD 3)",2,0,0,0,2
"Newport News City",-,"309 - Magruder (CD 3)",1,0,1,0,2
"Newport News City",-,"310 - Marshall (CD 3)",0,1,1,0,2
"Newport News City",-,"311 - Newmarket (CD 3)",30,38,12,0,80
"Newport News City",-,"312 - Newsome Park (CD 3)",0,0,0,0,0
"Newport News City",-,"313 - Reed (CD 3)",2,2,2,0,6
"Newport News City",-,"314 - River (CD 3)",37,38,37,0,112
"Newport News City",-,"315 - Sedgefield (CD 3)",54,55,20,0,129
"Newport News City",-,"316 - South Morrison (CD 3)",40,57,21,0,118
"Newport News City",-,"317 - Washington (CD 3)",0,1,0,0,1
"Newport News City",-,"318 - Wilson (CD 3)",8,7,3,0,18
"Newport News City",-,"319 - Saunders (CD 3)",96,114,46,1,257
"Newport News City",-,"320 - Watkins (CD 3)",92,135,69,1,297
"Newport News City",-,"Ab - Central Absentee Precinct (CD 3)",35,38,21,0,94
"Newport News City",-,"Provisional (CD 3)",1,0,0,0,1
"Norfolk City",-,"101 - Granby (CD 2)",0,2,0,0,2
"Norfolk City",-,"101 - Granby (CD 3)",74,53,23,0,150
"Norfolk City",-,"102 - Ocean View School (CD 2)",44,28,19,0,91
"Norfolk City",-,"103 - Northside (CD 2)",54,84,30,0,168
"Norfolk City",-,"104 - Titustown (CD 2)",3,3,7,0,13
"Norfolk City",-,"104 - Titustown (CD 3)",0,0,0,0,0
"Norfolk City",-,"106 - Second Presbyterian (CD 2)",54,63,31,0,148
"Norfolk City",-,"201 - Larchmont School (CD 3)",89,66,52,0,207
"Norfolk City",-,"203 - Ghent Square (CD 3)",35,23,14,0,72
"Norfolk City",-,"207 - Lambert's Point (CD 3)",12,3,4,0,19
"Norfolk City",-,"208 - Larchmont Library (CD 3)",32,27,26,0,85
"Norfolk City",-,"210 - Maury (CD 3)",42,19,18,0,79
"Norfolk City",-,"211 - Chrysler Museum (CD 3)",79,45,56,0,180
"Norfolk City",-,"212 - Park Place (CD 3)",2,1,4,0,7
"Norfolk City",-,"213 - Taylor Elementary School (CD 3)",41,21,23,0,85
"Norfolk City",-,"214 - Stuart (CD 3)",48,21,19,0,88
"Norfolk City",-,"215 - Suburban Park (CD 2)",73,66,35,0,174
"Norfolk City",-,"217 - Wesley (CD 2)",37,26,12,0,75
"Norfolk City",-,"218 - Willard (CD 3)",80,90,34,0,204
"Norfolk City",-,"301 - Ballentine (CD 3)",11,10,5,0,26
"Norfolk City",-,"302 - Tanners Creek (CD 3)",11,9,3,0,23
"Norfolk City",-,"303 - Broad Creek (CD 3)",7,8,2,0,17
"Norfolk City",-,"304 - Coleman Place School (CD 3)",7,13,3,0,23
"Norfolk City",-,"305 - Lafayette-winona (CD 3)",17,14,7,0,38
"Norfolk City",-,"306 - Lindenwood (CD 3)",8,3,4,0,15
"Norfolk City",-,"309 - Norview (CD 3)",30,27,21,0,78
"Norfolk City",-,"310 - Rosemont (CD 3)",4,1,4,0,9
"Norfolk City",-,"311 - Sherwood (CD 3)",62,59,35,0,156
"Norfolk City",-,"313 - Union Chapel (CD 3)",5,3,0,0,8
"Norfolk City",-,"402 - Berkley (CD 3)",0,0,2,0,2
"Norfolk City",-,"403 - Brambleton (CD 3)",1,2,1,0,4
"Norfolk City",-,"404 - Campostella (CD 3)",0,3,2,0,5
"Norfolk City",-,"405 - Chesterfield (CD 3)",2,2,1,0,5
"Norfolk City",-,"406 - Barron Black (CD 2)",45,33,15,0,93
"Norfolk City",-,"408 - Easton (CD 3)",55,54,39,0,148
"Norfolk City",-,"409 - Fairlawn (CD 3)",39,51,16,0,106
"Norfolk City",-,"411 - Ruffner Academy (CD 3)",0,0,0,0,0
"Norfolk City",-,"412 - Ingleside (CD 3)",23,16,6,0,45
"Norfolk City",-,"413 - Poplar Halls (CD 3)",26,30,11,0,67
"Norfolk City",-,"414 - Young Park (CD 3)",0,0,0,0,0
"Norfolk City",-,"415 - Lake Taylor High School (CD 3)",22,31,10,0,63
"Norfolk City",-,"501 - Bayview (CD 2)",81,90,37,0,208
"Norfolk City",-,"503 - East Ocean View (CD 2)",72,58,62,0,192
"Norfolk City",-,"504 - Larrymore (CD 2)",71,47,16,0,134
"Norfolk City",-,"505 - Little Creek (CD 2)",44,48,25,0,117
"Norfolk City",-,"506 - Ocean View Center (CD 2)",58,50,21,0,129
"Norfolk City",-,"507 - Pretlow (CD 2)",80,75,24,0,179
"Norfolk City",-,"509 - Tarrallton (CD 2)",77,101,47,0,225
"Norfolk City",-,"510 - Third Presbyterian (CD 2)",95,109,50,0,254
"Norfolk City",-,"511 - Crossroads (CD 2)",67,69,48,0,184
"Norfolk City",-,"512 - Azalea Gardens (CD 2)",38,56,31,0,125
"Norfolk City",-,"Ab - Central Absentee Precinct (CD 2)",16,18,9,0,43
"Norfolk City",-,"Ab - Central Absentee Precinct (CD 3)",17,12,11,0,40
"Norfolk City",-,"Provisional (CD 2)",0,0,0,0,0
"Norfolk City",-,"Provisional (CD 3)",1,0,0,0,1
"Northampton County",-,"101 - Precinct 1-1",67,58,22,0,147
"Northampton County",-,"201 - Precinct 2-1",16,17,10,0,43
"Northampton County",-,"301 - Precinct 3-1",15,37,8,0,60
"Northampton County",-,"401 - Precinct 4-1",36,45,21,0,102
"Northampton County",-,"501 - Precinct 5-1",54,61,30,0,145
"Northampton County",-,"Ab - Central Absentee Precinct",16,6,3,0,25
"Northampton County",-,Provisional,0,0,0,0,0
"Northumberland County",-,"101 - 1a",73,78,24,0,175
"Northumberland County",-,"201 - 2a",88,127,14,0,229
"Northumberland County",-,"301 - 3a",26,29,8,0,63
"Northumberland County",-,"302 - 3b",6,6,0,0,12
"Northumberland County",-,"401 - 4a",134,170,40,0,344
"Northumberland County",-,"501 - 5a",140,164,41,0,345
"Northumberland County",-,"Ab - Central Absentee Precinct",17,14,7,0,38
"Northumberland County",-,Provisional,0,1,0,0,1
"Norton City",-,"1 - East Ward",22,29,31,0,82
"Norton City",-,Provisional,0,0,0,0,0
"Nottoway County",-,"101 - Precinct 1-1",27,24,6,0,57
"Nottoway County",-,"102 - Precinct 1-2",11,31,5,0,47
"Nottoway County",-,"201 - Precinct 2-1",46,65,10,0,121
"Nottoway County",-,"202 - Precinct 2-2",17,27,4,0,48
"Nottoway County",-,"301 - Precinct 3-1",5,20,3,0,28
"Nottoway County",-,"302 - Precinct 3-2",16,19,3,0,38
"Nottoway County",-,"401 - Precinct 4-1",9,6,2,0,17
"Nottoway County",-,"402 - Precinct 4-2",30,49,6,0,85
"Nottoway County",-,"501 - Precinct 5-1",43,65,13,0,121
"Nottoway County",-,"Ab - Central Absentee Precinct",4,10,3,0,17
"Nottoway County",-,Provisional,0,0,0,0,0
"Orange County",-,"101 - One West",37,166,24,0,227
"Orange County",-,"102 - One East",24,140,15,0,179
"Orange County",-,"201 - Two West",28,134,10,0,172
"Orange County",-,"202 - Two East",30,144,7,0,181
"Orange County",-,"301 - Three West",35,146,6,0,187
"Orange County",-,"302 - Three East",9,64,2,0,75
"Orange County",-,"401 - Four West",40,188,8,0,236
"Orange County",-,"402 - Four East",40,131,3,0,174
"Orange County",-,"501 - Five South",64,211,15,0,290
"Orange County",-,"502 - Five North",65,325,24,0,414
"Orange County",-,"Ab - Central Absentee Precinct",8,52,2,0,62
"Orange County",-,Provisional,0,0,0,0,0
"Page County",-,"101 - West Luray",88,99,16,0,203
"Page County",-,"201 - East Luray",85,154,26,0,265
"Page County",-,"301 - Marksville",93,80,46,0,219
"Page County",-,"401 - Newport",45,59,24,0,128
"Page County",-,"501 - Shenandoah",85,73,49,0,207
"Page County",-,"Ab - Central Absentee Precinct",19,16,3,0,38
"Page County",-,Provisional,0,0,0,0,0
"Patrick County",-,"101 - Ararat",6,7,7,0,20
"Patrick County",-,"102 - Claudville",30,15,13,0,58
"Patrick County",-,"103 - Willis Gap",21,15,9,0,45
"Patrick County",-,"201 - Dry Pond",5,4,10,0,19
"Patrick County",-,"202 - Patrick Springs",11,24,13,0,48
"Patrick County",-,"203 - Russell Creek",14,10,4,0,28
"Patrick County",-,"301 - Critz/stella",23,30,19,0,72
"Patrick County",-,"302 - Liberty",20,17,10,0,47
"Patrick County",-,"401 - Meadows Of Dan",17,28,11,0,56
"Patrick County",-,"402 - Stuart Administration",39,15,8,0,62
"Patrick County",-,"501 - Stuart Community",10,12,4,0,26
"Patrick County",-,"502 - Elamsville",17,26,13,0,56
"Patrick County",-,"503 - Woolwine",15,27,23,0,65
"Patrick County",-,"Ab - Central Absentee Precinct",4,12,2,0,18
"Patrick County",-,Provisional,0,0,0,0,0
"Petersburg City",-,"101 - First Ward First Precinct",11,9,8,0,28
"Petersburg City",-,"201 - Second Ward First Precinct",10,7,5,0,22
"Petersburg City",-,"301 - Third Ward First Precinct",20,12,8,0,40
"Petersburg City",-,"401 - Fourth Ward First Precinct",17,9,5,0,31
"Petersburg City",-,"501 - Fifth Ward First Precinct",6,8,6,0,20
"Petersburg City",-,"601 - Sixth Ward First Precinct",0,1,0,0,1
"Petersburg City",-,"701 - Seventh Ward First Precinct",3,18,2,0,23
"Petersburg City",-,"Ab - Central Absentee Precinct",16,18,6,0,40
"Petersburg City",-,Provisional,0,0,0,0,0
"Pittsylvania County",-,"103 - Twin Springs",68,126,46,0,240
"Pittsylvania County",-,"105 - Chatham",25,60,11,0,96
"Pittsylvania County",-,"106 - Tunstall",19,45,18,0,82
"Pittsylvania County",-,"108 - West Blairs",30,35,7,0,72
"Pittsylvania County",-,"201 - Callands",31,51,17,0,99
"Pittsylvania County",-,"202- Bearskin",4,15,4,0,23
"Pittsylvania County",-,"204 - Sandy Level",12,65,19,0,96
"Pittsylvania County",-,"206 - Climax",24,41,7,0,72
"Pittsylvania County",-,"207 - Gretna",44,101,30,0,175
"Pittsylvania County",-,"301 - Central",10,29,2,0,41
"Pittsylvania County",-,"305 - Riceville",13,24,3,0,40
"Pittsylvania County",-,"307 - East Blairs",7,12,3,0,22
"Pittsylvania County",-,"308 - Mt Airy",9,12,3,0,24
"Pittsylvania County",-,"309 - East Gretna",10,25,5,0,40
"Pittsylvania County",-,"402 - Keeling",41,50,20,0,111
"Pittsylvania County",-,"404 - Kentuck",57,86,31,0,174
"Pittsylvania County",-,"405 - Ringgold",64,99,53,0,216
"Pittsylvania County",-,"501 - Hurt",42,89,33,0,164
"Pittsylvania County",-,"502 - Motley Sycamore",39,79,40,0,158
"Pittsylvania County",-,"503 - Renan",25,51,15,0,91
"Pittsylvania County",-,"603 - Stony Mill",30,61,14,0,105
"Pittsylvania County",-,"604 - Swansonville",18,38,12,0,68
"Pittsylvania County",-,"605 - Whitmell",24,45,10,0,79
"Pittsylvania County",-,"606 - Brosville",15,30,5,0,50
"Pittsylvania County",-,"607 - Dry Fork",8,40,13,0,61
"Pittsylvania County",-,"702 - Bachelors Hall",61,70,29,0,160
"Pittsylvania County",-,"703 - Ferry Road",3,17,7,0,27
"Pittsylvania County",-,"704 - Mt Hermon",71,106,42,0,219
"Pittsylvania County",-,"705 - Mt Cross",28,52,24,0,104
"Pittsylvania County",-,"Ab - Central Absentee Precinct",23,34,10,0,67
"Pittsylvania County",-,Provisional,0,0,0,0,0
"Poquoson City",-,"1 - Central",118,139,53,0,310
"Poquoson City",-,"2 - Eastern",126,106,76,0,308
"Poquoson City",-,"3 - Western",166,187,67,0,420
"Poquoson City",-,"Ab - Central Absentee Precinct",10,12,10,0,32
"Poquoson City",-,Provisional,0,1,0,0,1
"Portsmouth City",-,"1 - Emanuel A. M. E. Church",48,39,20,0,107
"Portsmouth City",-,"5 - Hampton Roads Community Health Center",1,3,1,0,5
"Portsmouth City",-,"7- Park View Elementary School",13,16,9,0,38
"Portsmouth City",-,"9 - Third Baptist Church",17,10,9,0,36
"Portsmouth City",-,"10 - Port Norfolk Recreation Center",30,21,6,0,57
"Portsmouth City",-,"11 - Mt. Hermon Village",1,3,0,0,4
"Portsmouth City",-,"13 - St. Mark Missionary Baptist Church",1,1,0,0,2
"Portsmouth City",-,"14 - Emily N. Spong Preschool",2,2,1,0,5
"Portsmouth City",-,"16 - Cradock Middle School",37,28,13,0,78
"Portsmouth City",-,"17 - Victory Life Fellowship",26,26,10,0,62
"Portsmouth City",-,"19 - Fairview Heights Baptist Church",21,21,11,0,53
"Portsmouth City",-,"20 - Noble Street Baptist Church",12,16,8,0,36
"Portsmouth City",-,"21 - John F. Kennedy Community Center",0,5,0,0,5
"Portsmouth City",-,"22 - Forward Church",42,21,14,0,77
"Portsmouth City",-,"23 - Westhaven Baptist Church",61,47,15,0,123
"Portsmouth City",-,"24 - Willett Hall",29,22,7,0,58
"Portsmouth City",-,"25 - John Tyler Elementary School",38,40,19,0,97
"Portsmouth City",-,"26 - William E. Waters Middle School",1,1,1,0,3
"Portsmouth City",-,"27 - Cavalier Manor Recreation Center",4,1,1,0,6
"Portsmouth City",-,"28 - Lakeview Elementary School",1,3,4,0,8
"Portsmouth City",-,"29 - Saint Andrew's United Methodist Church",38,68,18,0,124
"Portsmouth City",-,"30 - The Rescue Church",56,50,15,0,121
"Portsmouth City",-,"31 - West Park Church Of Christ",38,52,8,0,98
"Portsmouth City",-,"32 - Hodges Manor Elementary School",59,77,22,0,158
"Portsmouth City",-,"33- Pinecrest Baptist Church",61,62,24,0,147
"Portsmouth City",-,"34- Churchland Branch Library",49,74,25,0,148
"Portsmouth City",-,"35 - Churchland Elementary School",67,80,20,0,167
"Portsmouth City",-,"36 - Scottish Rite Temple",148,118,37,0,303
"Portsmouth City",-,"37 - Churchland Middle School",51,56,19,0,126
"Portsmouth City",-,"38 - Grove Baptist Church",19,17,3,0,39
"Portsmouth City",-,"39 - River Shore Baptist Church",75,55,17,0,147
"Portsmouth City",-,"Ab - Central Absentee Precinct",15,8,3,0,26
"Portsmouth City",-,Provisional,0,0,0,0,0
"Powhatan County",-,"101 - Subletts",124,124,24,0,272
"Powhatan County",-,"102 - Manakin",109,90,29,0,228
"Powhatan County",-,"103 - Flat Rock",74,68,15,0,157
"Powhatan County",-,"201 - Powhatan Station",112,84,23,0,219
"Powhatan County",-,"202 - Graceland",114,106,28,0,248
"Powhatan County",-,"301 - Bethesda",115,85,21,0,221
"Powhatan County",-,"302 - Lee's Landing",75,65,17,0,157
"Powhatan County",-,"401 - Powhatan Courthouse",184,150,51,0,385
"Powhatan County",-,"402 - Mt Zion",57,55,5,0,117
"Powhatan County",-,"501 - Smith Cross Roads",97,37,5,0,139
"Powhatan County",-,"502 - Pineville",42,42,9,0,93
"Powhatan County",-,"503 - Tobaccoville",37,36,6,0,79
"Powhatan County",-,"Ab - Central Absentee Precinct",24,32,10,0,66
"Powhatan County",-,Provisional,0,0,0,0,0
"Prince Edward County",-,"101 - Farmville",36,66,11,0,113
"Prince Edward County",-,"201 - Lockett",57,59,15,0,131
"Prince Edward County",-,"301 - Leigh",18,32,10,0,60
"Prince Edward County",-,"302 - Mt Pleasant",10,15,5,0,30
"Prince Edward County",-,"401 - Hampden",22,33,9,0,64
"Prince Edward County",-,"501 - Darlington Hts",23,52,7,0,82
"Prince Edward County",-,"502 - Buffalo Hts",14,33,5,0,52
"Prince Edward County",-,"601 - Prospect",35,62,7,0,104
"Prince Edward County",-,"701 - West End",32,58,14,0,104
"Prince Edward County",-,"801 - Center",12,4,2,0,18
"Prince Edward County",-,"Ab - Central Absentee Precinct",11,21,1,0,33
"Prince Edward County",-,Provisional,0,0,0,0,0
"Prince George County",-,"101 - Richard Bland (CD 4)",71,69,22,0,162
"Prince George County",-,"102 - Templeton (CD 4)",164,174,41,0,379
"Prince George County",-,"103 - Union Branch (CD 4)",88,93,25,0,206
"Prince George County",-,"104 - Rives (CD 4)",27,33,15,0,75
"Prince George County",-,"105 - Harrison (CD 4)",38,45,6,0,89
"Prince George County",-,"201 - Bland (CD 4)",131,181,41,0,353
"Prince George County",-,"202 - Black Water (CD 4)",126,97,34,0,257
"Prince George County",-,"203 - Brandon (CD 4)",41,46,9,0,96
"Prince George County",-,"204 - Courts Bldg (CD 4)",84,98,18,0,200
"Prince George County",-,"205 - Jefferson Park (CD 4)",21,40,6,0,67
"Prince George County",-,"Ab - Central Absentee Precinct (CD 4)",36,17,7,0,60
"Prince George County",-,"Provisional (CD 4)",0,0,0,0,0
"Prince William County",-,"101 - Brentsville (CD 1)",143,81,70,0,294
"Prince William County",-,"102 - Cedar Point (CD 1)",146,78,64,0,288
"Prince William County",-,"103 - Glenkirk (CD 1)",132,57,46,0,235
"Prince William County",-,"104 - Nokesville (CD 1)",150,71,57,0,278
"Prince William County",-,"105 - Limestone (CD 1)",132,55,57,0,244
"Prince William County",-,"106 - Westgate (CD 1)",37,21,26,0,84
"Prince William County",-,"107 - Marsteller (CD 1)",167,66,63,0,296
"Prince William County",-,"108 - Victory (CD 1)",113,67,48,0,228
"Prince William County",-,"109 - Piney Branch (CD 1)",82,33,34,0,149
"Prince William County",-,"110 - Buckland Mills (CD 1)",39,15,7,0,61
"Prince William County",-,"110 - Buckland Mills (CD 10)",60,23,21,0,104
"Prince William County",-,"111 - Bristow Run (CD 1)",173,76,62,0,311
"Prince William County",-,"112 - Burke-nickens (CD 1)",1,4,0,0,5
"Prince William County",-,"112 - Burke-nickens (CD 10)",105,39,29,0,173
"Prince William County",-,"201 - Saunders (CD 11)",38,25,28,0,91
"Prince William County",-,"202 - Marshall (CD 1)",205,72,92,0,369
"Prince William County",-,"203 - Bennett (CD 1)",131,71,45,0,247
"Prince William County",-,"204 - Ellis (CD 1)",79,60,40,0,179
"Prince William County",-,"205 - Buckhall (CD 10)",142,58,56,0,256
"Prince William County",-,"206 - Coles (CD 1)",133,114,47,0,294
"Prince William County",-,"207 - Spriggs (CD 1)",114,53,52,0,219
"Prince William County",-,"208 - Hylton (CD 1)",134,46,59,0,239
"Prince William County",-,"209 - Independent Hill (CD 1)",143,70,52,0,265
"Prince William County",-,"210 - Penn (CD 1)",169,70,69,0,308
"Prince William County",-,"210 - Penn (CD 11)",3,4,6,0,13
"Prince William County",-,"211 - Signal Hill (CD 10)",107,79,44,0,230
"Prince William County",-,"212 - Yorkshire (CD 10)",92,41,55,0,188
"Prince William County",-,"213 - Saratoga (CD 1)",64,18,19,0,101
"Prince William County",-,"214 - Lucasville (CD 1)",105,48,58,0,211
"Prince William County",-,"215 - Rosa Parks (CD 11)",57,30,27,0,114
"Prince William County",-,"301 - Dumfries (CD 11)",49,22,15,0,86
"Prince William County",-,"302 - Potomac (CD 11)",34,19,12,0,65
"Prince William County",-,"303 - Graham Park (CD 11)",21,12,9,0,42
"Prince William County",-,"304 - Quantico (CD 1)",11,10,8,1,30
"Prince William County",-,"305 - Pattie (CD 1)",115,47,43,0,205
"Prince William County",-,"306 - Washington-reid (CD 1)",138,64,87,0,289
"Prince William County",-,"307 - Henderson (CD 1)",127,54,49,0,230
"Prince William County",-,"308 - Montclair (CD 1)",73,41,28,0,142
"Prince William County",-,"309 - Ashland (CD 1)",67,49,33,0,149
"Prince William County",-,"310 - Forest Park (CD 1)",77,36,25,0,138
"Prince William County",-,"311 - Swans Creek (CD 11)",63,24,28,0,115
"Prince William County",-,"312 - Triangle (CD 1)",8,7,3,0,18
"Prince William County",-,"312 - Triangle (CD 11)",64,33,31,0,128
"Prince William County",-,"313 - Cardinal (CD 1)",53,28,25,0,106
"Prince William County",-,"314 - Cabin Branch (CD 1)",57,37,19,0,113
"Prince William County",-,"401 - Evergreen (CD 10)",187,58,131,0,376
"Prince William County",-,"402 - Battlefield (CD 10)",209,63,39,0,311
"Prince William County",-,"403 - Bull Run (CD 10)",88,33,19,0,140
"Prince William County",-,"404 - Ben Lomond (CD 1)",44,19,29,0,92
"Prince William County",-,"405 - Stonewall (CD 1)",76,27,38,0,141
"Prince William County",-,"406 - Alvey (CD 10)",139,39,30,0,208
"Prince William County",-,"407 - Heritage Hunt (CD 10)",371,216,113,0,700
"Prince William County",-,"408 - Sudley (CD 1)",84,47,46,0,177
"Prince William County",-,"409 - Tyler (CD 10)",92,35,23,0,150
"Prince William County",-,"410 - Mountain View (CD 10)",153,39,30,0,222
"Prince William County",-,"411 - Mullen (CD 1)",28,13,12,0,53
"Prince William County",-,"412 - Catharpin (CD 10)",128,62,40,0,230
"Prince William County",-,"413 - Reagan (CD 10)",163,63,38,0,264
"Prince William County",-,"501 - Lake Ridge (CD 1)",94,35,36,0,165
"Prince William County",-,"502 - Occoquan (CD 11)",58,25,25,0,108
"Prince William County",-,"503 - Old Bridge (CD 11)",42,15,43,0,100
"Prince William County",-,"504 - Rockledge (CD 11)",122,53,36,1,212
"Prince William County",-,"505 - Mohican (CD 1)",89,48,40,0,177
"Prince William County",-,"506 - Bethel (CD 11)",116,48,56,1,221
"Prince William County",-,"507 - Chinn (CD 11)",93,36,47,0,176
"Prince William County",-,"508 - Springwoods (CD 1)",40,24,19,0,83
"Prince William County",-,"509 - Mc Coart (CD 1)",190,85,71,0,346
"Prince William County",-,"510 - Yates Ford (CD 10)",125,56,66,0,247
"Prince William County",-,"511 - Westridge (CD 1)",90,45,33,0,168
"Prince William County",-,"512 - York (CD 11)",34,11,13,0,58
"Prince William County",-,"513 - Lynnwood (CD 11)",155,65,52,0,272
"Prince William County",-,"514 - Antietam (CD 11)",121,60,49,0,230
"Prince William County",-,"601 - Dale (CD 11)",26,25,14,0,65
"Prince William County",-,"602 - Beville (CD 11)",78,33,30,0,141
"Prince William County",-,"603 - Hampton (CD 11)",24,11,14,0,49
"Prince William County",-,"604 - Gideon (CD 11)",52,15,20,0,87
"Prince William County",-,"605 - Minnieville (CD 11)",53,41,25,0,119
"Prince William County",-,"606 - Bel Air (CD 11)",63,35,19,0,117
"Prince William County",-,"607 - Kerrydale (CD 11)",62,25,26,0,113
"Prince William County",-,"608 - Enterprise (CD 11)",59,33,19,0,111
"Prince William County",-,"609 - King (CD 1)",0,0,0,0,0
"Prince William County",-,"609 - King (CD 11)",75,40,30,0,145
"Prince William County",-,"610 - Fitzgerald (CD 11)",53,32,31,0,116
"Prince William County",-,"611 - Neabsco (CD 11)",40,22,20,0,82
"Prince William County",-,"701 - Belmont (CD 11)",96,35,29,0,160
"Prince William County",-,"702 - Library (CD 11)",46,13,18,0,77
"Prince William County",-,"703 - Lynn (CD 11)",15,13,6,0,34
"Prince William County",-,"704 - Porter (CD 11)",26,17,10,0,53
"Prince William County",-,"705 - Potomac View (CD 11)",63,37,28,0,128
"Prince William County",-,"706 - Rippon (CD 11)",60,44,41,0,145
"Prince William County",-,"707 - Kilby (CD 11)",28,25,16,0,69
"Prince William County",-,"708 - River Oaks (CD 11)",26,10,8,0,44
"Prince William County",-,"709 - Freedom (CD 11)",30,26,8,0,64
"Prince William County",-,"710 - Powells Creek (CD 11)",10,8,7,0,25
"Prince William County",-,"711 - Grayson (CD 11)",35,30,11,0,76
"Prince William County",-,"712 - Leesylvania (CD 11)",76,57,37,0,170
"Prince William County",-,"Ab - Central Absentee Precinct (CD 1)",178,103,51,0,332
"Prince William County",-,"Ab - Central Absentee Precinct (CD 10)",81,30,16,0,127
"Prince William County",-,"Ab - Central Absentee Precinct (CD 11)",132,70,41,0,243
"Prince William County",-,"Provisional (CD 1)",13,4,6,0,23
"Prince William County",-,"Provisional (CD 10)",0,0,0,0,0
"Prince William County",-,"Provisional (CD 11)",0,0,0,0,0
"Pulaski County",-,"101 - Belspring",15,29,6,0,50
"Pulaski County",-,"102 - New River",43,75,31,0,149
"Pulaski County",-,"103 - West Cloyd",22,39,17,0,78
"Pulaski County",-,"201 - Draper",33,48,24,0,105
"Pulaski County",-,"202 - South Pulaski",2,9,3,0,14
"Pulaski County",-,"203 - Newbern",36,72,17,0,125
"Pulaski County",-,"301 - Dublin",43,56,17,0,116
"Pulaski County",-,"302 - Hiwassee",2,25,1,0,28
"Pulaski County",-,"304 - Snowville",11,51,18,0,80
"Pulaski County",-,"401 - Massie",47,95,25,0,167
"Pulaski County",-,"402 - Walker",10,40,8,0,58
"Pulaski County",-,"501 - Robinson",33,64,25,0,122
"Pulaski County",-,"Ab - Central Absentee Precinct",9,6,5,0,20
"Pulaski County",-,Provisional,0,0,0,0,0
"Radford City",-,"1 - East Precinct",41,28,15,0,84
"Radford City",-,"2 - Central Precinct",51,59,23,0,133
"Radford City",-,"3 - West Precinct",40,69,29,0,138
"Radford City",-,"Ab - Central Absentee Precinct",9,5,2,0,16
"Radford City",-,Provisional,0,1,0,0,1
"Rappahannock County",-,"101 - Washington",71,25,16,0,112
"Rappahannock County",-,"201 - Amissville",59,26,36,0,121
"Rappahannock County",-,"301 - Sperryville",51,22,19,0,92
"Rappahannock County",-,"401 - Scrabble",38,31,19,0,88
"Rappahannock County",-,"501 - Chester Gap",38,17,3,0,58
"Rappahannock County",-,"502 - Flint Hill",50,10,9,0,69
"Rappahannock County",-,"Ab - Central Absentee Precinct",15,5,5,0,25
"Rappahannock County",-,Provisional,1,1,0,0,2
"Richmond County",-,"101 - Precinct 1-1",11,26,10,0,47
"Richmond County",-,"201 - Precinct 2-1",20,29,6,0,55
"Richmond County",-,"301 - Precinct 3-1",27,36,13,0,76
"Richmond County",-,"401 - Precinct 4-1",31,35,15,0,81
"Richmond County",-,"501 - Precinct 5-1",41,30,5,0,76
"Richmond County",-,"Ab - Central Absentee Precinct",3,2,2,0,7
"Richmond County",-,Provisional,0,0,0,0,0
"Richmond City",-,"101 - One Hundred One (CD 4)",90,56,36,1,183
"Richmond City",-,"102 - One Hundred Two (CD 4)",66,41,20,0,127
"Richmond City",-,"104 - One Hundred Four (CD 4)",106,59,24,0,189
"Richmond City",-,"105 - One Hundred Five (CD 4)",72,31,30,0,133
"Richmond City",-,"106 - One Hundred Six (CD 4)",138,87,44,0,269
"Richmond City",-,"111 - One Hundred Eleven (CD 4)",75,34,12,0,121
"Richmond City",-,"112 - One Hundred Twelve (CD 4)",56,29,16,0,101
"Richmond City",-,"113 - One Hundred Thirteen (CD 4)",48,17,14,0,79
"Richmond City",-,"114 - One Hundred Fourteen (CD 4)",67,20,23,0,110
"Richmond City",-,"203 - Two Hundred Three (CD 4)",32,28,12,0,72
"Richmond City",-,"204 - Two Hundred Four (CD 4)",54,29,19,0,102
"Richmond City",-,"206 - Two Hundred Six (CD 4)",14,14,4,0,32
"Richmond City",-,"207 - Two Hundred Seven (CD 4)",38,32,20,0,90
"Richmond City",-,"208 - Two Hundred Eight (CD 4)",74,23,12,0,109
"Richmond City",-,"213 - Two Hundred Thirteen (CD 4)",12,3,4,0,19
"Richmond City",-,"301 - Three Hundred One (CD 4)",1,3,2,0,6
"Richmond City",-,"302 - Three Hundred Two (CD 4)",16,10,6,0,32
"Richmond City",-,"303 - Three Hundred Three (CD 4)",5,3,2,0,10
"Richmond City",-,"304 - Three Hundred Four (CD 4)",2,0,4,0,6
"Richmond City",-,"305 - Three Hundred Five (CD 4)",5,6,2,0,13
"Richmond City",-,"306 - Three Hundred Six (CD 4)",1,2,0,0,3
"Richmond City",-,"307 - Three Hundred Seven (CD 4)",35,14,8,0,57
"Richmond City",-,"308 - Three Hundred Eight (CD 4)",36,24,10,0,70
"Richmond City",-,"309 - Three Hundred Nine (CD 4)",47,50,14,0,111
"Richmond City",-,"310 - Three Hundred Ten (CD 4)",0,0,0,0,0
"Richmond City",-,"402 - Four Hundred Two (CD 4)",75,49,24,0,148
"Richmond City",-,"404 - Four Hundred Four (CD 4)",42,37,10,0,89
"Richmond City",-,"409 - Four Hundred Nine (CD 4)",147,123,29,0,299
"Richmond City",-,"410 - Four Hundred Ten (CD 4)",48,46,8,0,102
"Richmond City",-,"412 - Four Hundred Twelve (CD 4)",46,28,16,0,90
"Richmond City",-,"413 - Four Hundred Thirteen (CD 4)",76,41,23,0,140
"Richmond City",-,"414 - Four Hundred Fourteen (CD 4)",83,73,29,0,185
"Richmond City",-,"501 - Five Hundred One (CD 4)",25,10,6,0,41
"Richmond City",-,"503 - Five Hundred Three (CD 4)",10,9,5,0,24
"Richmond City",-,"504 - Five Hundred Four (CD 4)",20,7,9,0,36
"Richmond City",-,"505 - Five Hundred Five (CD 4)",8,7,2,0,17
"Richmond City",-,"508 - Five Hundred Eight (CD 4)",24,11,14,0,49
"Richmond City",-,"509 - Five Hundred Nine (CD 4)",6,7,2,0,15
"Richmond City",-,"510 - Five Hundred Ten (CD 4)",7,5,1,0,13
"Richmond City",-,"602 - Six Hundred Two (CD 4)",1,0,0,0,1
"Richmond City",-,"603 - Six Hundred Three (CD 4)",4,4,2,0,10
"Richmond City",-,"604 - Six Hundred Four (CD 4)",2,2,1,0,5
"Richmond City",-,"606 - Six Hundred Six (CD 4)",4,3,3,0,10
"Richmond City",-,"607 - Six Hundred Seven (CD 4)",17,7,5,0,29
"Richmond City",-,"609 - Six Hundred Nine (CD 4)",6,7,4,0,17
"Richmond City",-,"610 - Six Hundred Ten (CD 4)",1,1,0,0,2
"Richmond City",-,"701 - Seven Hundred One (CD 4)",1,2,1,0,4
"Richmond City",-,"702 - Seven Hundred Two (CD 4)",0,3,1,0,4
"Richmond City",-,"703 - Seven Hundred Three (CD 4)",3,0,2,0,5
"Richmond City",-,"705 - Seven Hundred Five (CD 4)",7,4,5,0,16
"Richmond City",-,"706 - Seven Hundred Six (CD 4)",10,14,4,0,28
"Richmond City",-,"707 - Seven Hundred Seven (CD 4)",43,17,9,0,69
"Richmond City",-,"708 - Seven Hundred Eight (CD 4)",12,13,3,0,28
"Richmond City",-,"802 - Eight Hundred Two (CD 4)",2,1,1,0,4
"Richmond City",-,"806 - Eight Hundred Six (CD 4)",11,7,2,0,20
"Richmond City",-,"810 - Eight Hundred Ten (CD 4)",9,10,3,0,22
"Richmond City",-,"811 - Eight Hundred Eleven (CD 4)",11,6,1,0,18
"Richmond City",-,"812 - Eight Hundred Twelve (CD 4)",20,24,9,0,53
"Richmond City",-,"814 - Eight Hundred Fourteen (CD 4)",1,6,3,0,10
"Richmond City",-,"902 - Nine Hundred Two (CD 4)",2,2,0,0,4
"Richmond City",-,"903 - Nine Hundred Three (CD 4)",9,12,3,0,24
"Richmond City",-,"908 - Nine Hundred Eight (CD 4)",8,11,5,0,24
"Richmond City",-,"909 - Nine Hundred Nine (CD 4)",13,14,1,0,28
"Richmond City",-,"910 - Nine Hundred Ten (CD 4)",11,11,3,0,25
"Richmond City",-,"911 - Nine Hundred Eleven (CD 4)",3,6,0,0,9
"Richmond City",-,"AB - Central Absentee Precinct (CD 4)",49,33,9,0,91
"Richmond City",-,"Provisional (CD 4)",0,0,0,0,0
"Roanoke County",-,"101 - Catawba (CD 9)",30,33,11,0,74
"Roanoke County",-,"102 - Mason Valley (CD 9)",22,45,9,0,76
"Roanoke County",-,"103 - Glenvar (CD 9)",47,82,25,0,154
"Roanoke County",-,"104 - Northside (CD 9)",34,48,10,0,92
"Roanoke County",-,"105 - Peters Creek (CD 9)",84,130,29,0,243
"Roanoke County",-,"106 - Green Hill (CD 9)",62,108,36,0,206
"Roanoke County",-,"107 - Bennett Springs (CD 9)",21,59,10,0,90
"Roanoke County",-,"108 - Wildwood (CD 9)",30,67,6,0,103
"Roanoke County",-,"201 - Plantation (CD 6)",51,130,26,0,207
"Roanoke County",-,"202 - Burlington (CD 6)",40,70,20,0,130
"Roanoke County",-,"203 - Mountain View (CD 6)",122,217,95,0,434
"Roanoke County",-,"204 - Botetourt Springs (CD 9)",104,150,47,0,301
"Roanoke County",-,"205 - Orchards (CD 6)",154,247,71,0,472
"Roanoke County",-,"206 - Hollins (CD 6)",28,58,26,0,112
"Roanoke County",-,"301 - Bent Mountain (CD 9)",25,42,17,0,84
"Roanoke County",-,"302 - Poages Mill (CD 6)",109,156,85,0,350
"Roanoke County",-,"303 - Windsor Hills (CD 6)",64,93,44,0,201
"Roanoke County",-,"304 - Oak Grove (CD 6)",118,184,110,0,412
"Roanoke County",-,"305 - Castle Rock (CD 6)",163,159,79,0,401
"Roanoke County",-,"306 - Garst Mill (CD 6)",44,60,42,0,146
"Roanoke County",-,"402 - Bonsack (CD 6)",22,50,17,0,89
"Roanoke County",-,"403 - North Vinton (CD 6)",50,112,36,0,198
"Roanoke County",-,"404 - South Vinton (CD 6)",43,95,74,0,212
"Roanoke County",-,"405 - Lindenwood (CD 6)",109,213,109,0,431
"Roanoke County",-,"406 - Mount Pleasant (CD 6)",70,166,33,0,269
"Roanoke County",-,"501 - Cotton Hill (CD 6)",47,44,24,0,115
"Roanoke County",-,"502 - Penn Forest (CD 6)",49,42,20,0,111
"Roanoke County",-,"503 - Cave Spring (CD 6)",56,77,25,0,158
"Roanoke County",-,"504 - Ogden (CD 6)",34,42,10,0,86
"Roanoke County",-,"505 - Clearbrook (CD 6)",33,73,28,0,134
"Roanoke County",-,"506 - Mount Vernon (CD 6)",35,50,28,0,113
"Roanoke County",-,"507 - Hunting Hills (CD 6)",95,82,57,0,234
"Roanoke County",-,"Ab - Central Absentee Precinct (CD 6)",67,93,37,0,197
"Roanoke County",-,"Ab - Central Absentee Precinct (CD 9)",13,20,9,0,42
"Roanoke County",-,"Provisional (CD 6)",0,0,0,0,0
"Roanoke County",-,"Provisional (CD 9)",0,0,0,0,0
"Roanoke City",-,"1 -Peters Creek",16,23,4,0,43
"Roanoke City",-,"2 - Grandview",30,58,14,0,102
"Roanoke City",-,"3 -Preston Park",56,102,22,0,180
"Roanoke City",-,"4 - Williamson Road",30,61,11,0,102
"Roanoke City",-,"5 - East Gate",43,77,12,0,132
"Roanoke City",-,"6 - Hollins Road",25,33,11,0,69
"Roanoke City",-,"7 - Southeast",30,43,13,0,86
"Roanoke City",-,"8 - Lincoln Terrace",3,5,3,0,11
"Roanoke City",-,"9 - Highland",23,27,13,0,63
"Roanoke City",-,"10 - Old Southwest-Wasena",30,31,19,0,80
"Roanoke City",-,"11 - Raleigh Court",45,74,15,0,134
"Roanoke City",-,"12 - South Roanoke",85,73,29,0,187
"Roanoke City",-,"13 - Garden City",27,79,22,0,128
"Roanoke City",-,"14 - Crystal Spring",72,84,30,0,186
"Roanoke City",-,"15 - Grandin Court",61,70,12,0,143
"Roanoke City",-,"16 - Deyerle",97,123,41,0,261
"Roanoke City",-,"17 - Lee-Hi",39,61,17,0,117
"Roanoke City",-,"18 - Virginia Heights-Norwich",36,38,15,0,89
"Roanoke City",-,"19 - Summit Hills",23,70,28,0,121
"Roanoke City",-,"20 - Forest Park",4,9,1,0,14
"Roanoke City",-,"21 - Eureka Park",6,15,1,0,22
"Roanoke City",-,"Ab - Central Absentee Precinct",15,27,14,0,56
"Roanoke City",-,Provisional,1,1,0,0,2
"Rockbridge County",-,"101 - Airport",39,59,18,0,116
"Rockbridge County",-,"102 - Ben Salem",23,49,17,0,89
"Rockbridge County",-,"103 - Plank Road",19,21,14,0,54
"Rockbridge County",-,"104 - Effinger",23,33,11,0,67
"Rockbridge County",-,"201 - Collierstown",19,40,12,0,71
"Rockbridge County",-,"202 - Highland Belle",46,88,42,0,176
"Rockbridge County",-,"203 - Vo-tech",5,20,12,0,37
"Rockbridge County",-,"301 - Maury River",10,25,11,0,46
"Rockbridge County",-,"302 - Natural Bridge",17,35,5,0,57
"Rockbridge County",-,"303 - Falling Spring",12,13,10,0,35
"Rockbridge County",-,"401 - Fairfield",23,41,18,0,82
"Rockbridge County",-,"402 - Mountain View",35,60,15,0,110
"Rockbridge County",-,"403 - Vesuvius",10,12,5,0,27
"Rockbridge County",-,"501 - Goshen",10,35,6,0,51
"Rockbridge County",-,"502 - Meadowview",33,22,15,0,70
"Rockbridge County",-,"503 - Rockbridge Baths",12,11,19,0,42
"Rockbridge County",-,"504 - Rockbridge",21,53,25,0,99
"Rockbridge County",-,"Ab - Central Absentee Precinct",21,15,7,0,43
"Rockbridge County",-,Provisional,0,0,0,0,0
"Rockingham County",-,"101 - Broadway",78,61,57,0,196
"Rockingham County",-,"102 - Timberville",45,11,22,0,78
"Rockingham County",-,"103 - Fulks Run",31,40,30,0,101
"Rockingham County",-,"104 - Bergton",25,14,14,0,53
"Rockingham County",-,"105 - Lacey Spring",50,21,21,0,92
"Rockingham County",-,"106 - Tenth Legion",30,14,29,0,73
"Rockingham County",-,"107 - Plains",43,23,20,0,86
"Rockingham County",-,"108 - Little North Mountain",23,11,24,0,58
"Rockingham County",-,"201 - Singers Glen",40,24,37,0,101
"Rockingham County",-,"202 - Edom",58,49,42,0,149
"Rockingham County",-,"203 - Dayton",28,22,28,0,78
"Rockingham County",-,"204 - Mt Clinton",51,30,43,0,124
"Rockingham County",-,"205 - Silver Lake",80,53,55,0,188
"Rockingham County",-,"301 - Keezletown",28,34,39,0,101
"Rockingham County",-,"302 - Port Republic",63,21,59,0,143
"Rockingham County",-,"303 - Melrose",31,18,27,0,76
"Rockingham County",-,"304 - Grottoes",48,27,53,0,128
"Rockingham County",-,"305 - Massanetta Springs",61,36,50,0,147
"Rockingham County",-,"306 - Cross Keys",38,30,15,0,83
"Rockingham County",-,"307 - Crossroads",103,78,90,0,271
"Rockingham County",-,"401 - Bridgewater",133,69,94,0,296
"Rockingham County",-,"402 - Montezuma",27,32,48,0,107
"Rockingham County",-,"403 - Mt Crawford",10,3,9,0,22
"Rockingham County",-,"404 - North River",36,28,49,0,113
"Rockingham County",-,"405 - Ottobine",43,37,49,0,129
"Rockingham County",-,"501 - Elkton",20,26,59,0,105
"Rockingham County",-,"502 - Swift Run",26,39,83,0,148
"Rockingham County",-,"503 - Mcgaheysville",65,38,46,0,149
"Rockingham County",-,"504 - South Fork",29,23,25,0,77
"Rockingham County",-,"505 - Stony Run",58,39,56,0,153
"Rockingham County",-,"Ab - Central Absentee Precinct",57,50,31,0,138
"Rockingham County",-,Provisional,0,0,0,0,0
"Russell County",-,"101 - Moccasin",12,12,6,0,30
"Russell County",-,"102 - Copper Creek",4,18,12,0,34
"Russell County",-,"103 - South Castlewood",6,14,4,0,24
"Russell County",-,"201 - North Castlewood",15,20,21,0,56
"Russell County",-,"202 - Dante",5,5,6,0,16
"Russell County",-,"301 - Cooks Mill",6,2,0,0,8
"Russell County",-,"302 - Daugherty",3,10,2,0,15
"Russell County",-,"303 - New Garden",8,3,6,0,17
"Russell County",-,"304 - Cleveland",5,5,5,0,15
"Russell County",-,"401 - Drill",0,1,3,0,4
"Russell County",-,"402 - Swords Creek",8,16,27,0,51
"Russell County",-,"403 - Honaker",3,11,4,0,18
"Russell County",-,"501 - West Lebanon",32,38,17,0,87
"Russell County",-,"601 - East Lebanon",21,24,20,0,65
"Russell County",-,"602 - Elk Garden",22,15,18,0,55
"Russell County",-,"Ab - Central Absentee Precinct",11,11,10,0,32
"Russell County",-,Provisional,0,0,0,0,0
"Salem City",-,"1 - North Salem No 2",68,76,20,0,164
"Salem City",-,"2 - Conehurst",11,33,4,0,48
"Salem City",-,"3 - Beverly Heights",24,58,9,0,91
"Salem City",-,"4 - West Salem",40,79,23,0,142
"Salem City",-,"5 - North Salem No 1",36,58,15,0,109
"Salem City",-,"6 - South Salem No 1",23,40,6,0,69
"Salem City",-,"7 - South Salem No 2",31,58,14,0,103
"Salem City",-,"8 - East Salem",12,30,7,0,49
"Salem City",-,"9 - South Side Hills",57,111,27,0,195
"Salem City",-,"10 - Hidden Valley",56,88,30,0,174
"Salem City",-,"Ab - Central Absentee Precinct",16,13,11,0,40
"Salem City",-,Provisional,0,0,0,0,0
"Scott County",-,"101 - Weber City",20,16,5,0,41
"Scott County",-,"102 - Yuma",11,21,14,0,46
"Scott County",-,"202 - Weber City East",17,17,13,0,47
"Scott County",-,"203 - Hiltons",13,12,17,0,42
"Scott County",-,"204 - Clark's",9,3,1,0,13
"Scott County",-,"301 - Nickelsville",16,3,10,0,29
"Scott County",-,"302 - Snowflake",7,14,11,0,32
"Scott County",-,"303 - Twin Springs",3,9,6,0,18
"Scott County",-,"304 - Copper Creek",1,0,0,0,1
"Scott County",-,"401 - Gate City",56,30,24,0,110
"Scott County",-,"501 - Dungannon",8,5,4,0,17
"Scott County",-,"502 - Fort Blackmore",5,9,1,0,15
"Scott County",-,"503 - Manville",4,7,4,0,15
"Scott County",-,"504 - Rye Cove",19,15,5,0,39
"Scott County",-,"601 - Clinchport",5,10,6,0,21
"Scott County",-,"602 - Duffield-pattonsville",18,17,13,0,48
"Scott County",-,"603 - Fairview",0,1,3,0,4
"Scott County",-,"Ab - Central Absentee Precinct",15,7,3,0,25
"Scott County",-,Provisional,0,0,0,0,0
"Shenandoah County",-,"101 - Orkney Springs",130,36,9,0,175
"Shenandoah County",-,"103 - New Market",231,51,40,0,322
"Shenandoah County",-,"201 - Conicville",148,36,14,0,198
"Shenandoah County",-,"202 - Mt Jackson",139,35,14,0,188
"Shenandoah County",-,"302 - Edinburg",177,21,22,0,220
"Shenandoah County",-,"303 - St Luke",154,28,11,0,193
"Shenandoah County",-,"304 - Fort Valley",97,32,7,0,136
"Shenandoah County",-,"401 - Woodstock",250,48,30,0,328
"Shenandoah County",-,"501 - Cedar Creek",15,3,2,0,20
"Shenandoah County",-,"503 - Toms Brook",175,53,23,0,251
"Shenandoah County",-,"504 - Lebanon Church",107,33,8,0,148
"Shenandoah County",-,"601 - Strasburg",190,63,14,0,267
"Shenandoah County",-,"Ab - Central Absentee Precinct",38,13,8,0,59
"Shenandoah County",-,Provisional,5,3,0,0,8
"Smyth County",-,"101 - Saltville",33,45,33,0,111
"Smyth County",-,"201 - Seven Mile Ford",18,24,22,0,64
"Smyth County",-,"202 - Rich Valley",7,8,9,0,24
"Smyth County",-,"301 - Chilhowie",40,40,38,0,118
"Smyth County",-,"302 - St Clair",4,10,9,0,23
"Smyth County",-,"401 - East Park",16,35,20,0,71
"Smyth County",-,"402 - West Park",10,12,12,0,34
"Smyth County",-,"501 - Atkins",16,31,16,0,63
"Smyth County",-,"502 - Wassona",25,23,14,0,62
"Smyth County",-,"601 - Royal Oak East",24,27,24,0,75
"Smyth County",-,"602 - Royal Oak West",9,17,11,0,37
"Smyth County",-,"701 - Adwolfe",25,25,27,0,77
"Smyth County",-,"702 - Sugar Grove",12,23,19,0,54
"Smyth County",-,"703 - Konnarock",5,2,5,0,12
"Smyth County",-,"Ab - Central Absentee Precinct",3,3,4,0,10
"Smyth County",-,Provisional,0,0,0,0,0
"Southampton County",-,"101 - Berlin",43,43,30,0,116
"Southampton County",-,"102 - Ivor",51,75,22,0,148
"Southampton County",-,"201 - Boykins",22,15,29,0,66
"Southampton County",-,"202 - Branchville",5,16,13,0,34
"Southampton County",-,"301 - Capron",23,25,28,0,76
"Southampton County",-,"302 - Sebrell",37,32,18,0,87
"Southampton County",-,"401 - Drewryville",10,12,13,0,35
"Southampton County",-,"501 - Hunterdale",61,95,29,0,185
"Southampton County",-,"502 - Forks-of-the-river",15,26,11,0,52
"Southampton County",-,"601 - Courtland",43,36,23,0,102
"Southampton County",-,"602 - Sedley",34,50,14,0,98
"Southampton County",-,"701 - Blackwater River",10,14,7,0,31
"Southampton County",-,"702 - Newsoms",25,37,9,0,71
"Southampton County",-,"Ab - Central Absentee Precinct",5,15,8,0,28
"Southampton County",-,Provisional,0,0,0,0,0
"Spotsylvania County",-,"101 - Partlow (CD 7)",62,127,26,0,215
"Spotsylvania County",-,"102 - Blaydes Corner (CD 7)",53,146,19,0,218
"Spotsylvania County",-,"103 - Travelers Rest (CD 1)",0,1,0,0,1
"Spotsylvania County",-,"103 - Travelers Rest (CD 7)",60,226,22,0,308
"Spotsylvania County",-,"104 - Massaponax (CD 1)",51,198,21,0,270
"Spotsylvania County",-,"201 - Wilderness School (CD 7)",49,193,7,0,249
"Spotsylvania County",-,"202 - Wilderness Fire (CD 7)",62,179,20,0,261
"Spotsylvania County",-,"203 - Ni River / Elys Ford (CD 7)",54,222,12,0,288
"Spotsylvania County",-,"204 - Chancellor (CD 7)",40,191,18,0,249
"Spotsylvania County",-,"301 - Plank Road (CD 7)",42,249,14,0,305
"Spotsylvania County",-,"302 - Hazel Run (CD 7)",35,209,12,0,256
"Spotsylvania County",-,"303 - Riverbend (CD 7)",91,324,25,0,440
"Spotsylvania County",-,"401 - Summit (CD 1)",54,214,24,0,292
"Spotsylvania County",-,"402 - Parkside (CD 1)",42,139,14,0,195
"Spotsylvania County",-,"402 - Parkside (CD 7)",8,36,3,0,47
"Spotsylvania County",-,"403 - Lee Hill (CD 1)",78,316,33,0,427
"Spotsylvania County",-,"501 - Belmont (CD 7)",78,137,25,0,240
"Spotsylvania County",-,"502 - Brokenburg (CD 7)",41,142,13,0,196
"Spotsylvania County",-,"503 - Post Oak (CD 7)",57,201,22,0,280
"Spotsylvania County",-,"504 - Courthouse (CD 7)",57,237,21,0,315
"Spotsylvania County",-,"505 - Brock (CD 7)",70,383,21,0,474
"Spotsylvania County",-,"601 - Salem (CD 7)",68,219,12,0,299
"Spotsylvania County",-,"602 - Smith Station (CD 7)",58,299,23,0,380
"Spotsylvania County",-,"603 - Piedmont (CD 7)",31,145,18,0,194
"Spotsylvania County",-,"701 - Battlefield (CD 1)",51,201,20,0,272
"Spotsylvania County",-,"702 - Brents Mill (CD 1)",38,88,9,0,135
"Spotsylvania County",-,"702 - Brents Mill (CD 7)",29,101,15,0,145
"Spotsylvania County",-,"703 - Fairview (CD 1)",9,25,3,0,37
"Spotsylvania County",-,"703 - Fairview (CD 7)",16,47,2,0,65
"Spotsylvania County",-,"704 - Gayle (CD 1)",45,155,16,0,216
"Spotsylvania County",-,"704 - Gayle (CD 7)",53,185,15,0,253
"Spotsylvania County",-,"Ab - Central Absentee Precinct (CD 1)",24,59,11,0,94
"Spotsylvania County",-,"Ab - Central Absentee Precinct (CD 7)",51,199,15,0,265
"Spotsylvania County",-,"Provisional (CD 1)",0,0,0,0,0
"Spotsylvania County",-,"Provisional (CD 7)",0,0,0,0,0
"Stafford County",-,"101 - Hartwood",171,349,30,0,550
"Stafford County",-,"102 - Rocky Run",113,115,37,0,265
"Stafford County",-,"103 - Simpson",93,125,35,0,253
"Stafford County",-,"104 - College",117,179,38,0,334
"Stafford County",-,"201 - Rock Hill",98,122,38,0,258
"Stafford County",-,"202 - Roseville",87,138,23,0,248
"Stafford County",-,"203 - Ruby",77,200,31,0,308
"Stafford County",-,"204 - Stefaniga",130,209,38,0,377
"Stafford County",-,"301 - Griffis",46,32,29,0,107
"Stafford County",-,"302 - Widewater",83,75,40,0,198
"Stafford County",-,"303 - Harbour",137,101,48,0,286
"Stafford County",-,"304 - Barrett",45,34,22,0,101
"Stafford County",-,"401 - Aquia",22,35,18,0,75
"Stafford County",-,"402 - Courthouse",128,128,69,0,325
"Stafford County",-,"403 - Brooke",205,320,100,0,625
"Stafford County",-,"404 - Government Island",185,160,79,0,424
"Stafford County",-,"501 - Grafton",144,344,92,0,580
"Stafford County",-,"502 - Falmouth",129,263,63,0,455
"Stafford County",-,"503 - Drew",110,162,49,0,321
"Stafford County",-,"504 - Gayle",89,148,44,0,281
"Stafford County",-,"601 - Ferry Farm",138,314,54,0,506
"Stafford County",-,"602 - Chatham",90,281,53,0,424
"Stafford County",-,"603 - White Oak",148,374,57,0,579
"Stafford County",-,"604 - England Run",25,39,12,0,76
"Stafford County",-,"701 - Woodlands",103,158,31,0,292
"Stafford County",-,"702 - Whitson",94,81,30,0,205
"Stafford County",-,"703 - Hampton",170,170,63,0,403
"Stafford County",-,"Ab - Central Absentee Precinct",98,133,42,0,273
"Stafford County",-,Provisional,2,1,0,0,3
"Staunton City",-,"101 - Ward No 1",58,76,45,0,179
"Staunton City",-,"201 - Ward Two",95,87,68,0,250
"Staunton City",-,"301 - Ward No 3",65,58,56,0,179
"Staunton City",-,"401 - Ward No 4",82,76,50,0,208
"Staunton City",-,"501 - Ward No 5",68,56,49,0,173
"Staunton City",-,"Ab - Central Absentee Precinct",7,12,13,0,32
"Staunton City",-,Provisional,1,0,1,0,2
"Suffolk City",-,"101 - Belleharbour (CD 3)",25,24,11,0,60
"Suffolk City",-,"102 - Driver (CD 3)",167,170,76,0,413
"Suffolk City",-,"104 - Bennetts Creek (CD 3)",66,69,34,0,169
"Suffolk City",-,"201 - Ebenezer (CD 3)",132,129,41,0,302
"Suffolk City",-,"202 - Chuckatuck (CD 3)",118,81,39,0,238
"Suffolk City",-,"203 - Kings Fork (CD 3)",67,71,34,0,172
"Suffolk City",-,"204 - Hillpoint (CD 3)",50,32,16,0,98
"Suffolk City",-,"301 - White Marsh (CD 4)",14,22,11,0,47
"Suffolk City",-,"302 - John F Kennedy (CD 3)",9,15,4,0,28
"Suffolk City",-,"302 - John F Kennedy (CD 4)",4,2,2,0,8
"Suffolk City",-,"304 - Nansemond River (CD 3)",61,45,22,0,128
"Suffolk City",-,"305 - Shoulders Hill (CD 3)",30,28,4,0,62
"Suffolk City",-,"401 - Airport (CD 4)",39,67,24,0,130
"Suffolk City",-,"402 - Whaleyville (CD 4)",94,105,41,0,240
"Suffolk City",-,"403 - Southside (CD 4)",5,2,4,0,11
"Suffolk City",-,"404 - Booker T Washington (CD 3)",0,0,0,0,0
"Suffolk City",-,"404 - Booker T Washington (CD 4)",3,4,4,0,11
"Suffolk City",-,"405 - Pittmantown (CD 4)",33,25,9,0,67
"Suffolk City",-,"501 - Kilbys Mill (CD 4)",94,130,36,0,260
"Suffolk City",-,"502 - Holland (CD 4)",101,101,91,0,293
"Suffolk City",-,"504 - Lake Cohoon (CD 3)",62,36,18,0,116
"Suffolk City",-,"504 - Lake Cohoon (CD 4)",67,108,34,0,209
"Suffolk City",-,"601 - Lakeside (CD 4)",74,44,66,0,184
"Suffolk City",-,"602 - Olde Towne (CD 3)",8,15,3,0,26
"Suffolk City",-,"602 - Olde Towne (CD 4)",0,0,0,0,0
"Suffolk City",-,"603 - Elephants Fork/westhaven (CD 4)",24,24,7,0,55
"Suffolk City",-,"604 - Wilroy (CD 3)",47,42,30,0,119
"Suffolk City",-,"605 - Hollywood (CD 3)",1,0,1,0,2
"Suffolk City",-,"702 - Harbourview (CD 3)",98,71,33,0,202
"Suffolk City",-,"704 - Burbage Grant (CD 3)",49,45,19,0,113
"Suffolk City",-,"706 - Huntersville (CD 3)",24,19,8,0,51
"Suffolk City",-,"AB - Central Absentee Precinct (CD 3)",16,28,12,0,56
"Suffolk City",-,"Ab - Central Absentee Precinct (CD 4)",10,4,11,0,25
"Suffolk City",-,"Provisional (CD 3)",1,0,0,0,1
"Suffolk City",-,"Provisional (CD 4)",0,0,0,0,0
"Surry County",-,"101 - Surry",58,35,22,0,115
"Surry County",-,"201 - Bacons Castle",21,22,14,0,57
"Surry County",-,"301 - Dendron",34,25,6,0,65
"Surry County",-,"302 - Walls Bridge",10,11,2,0,23
"Surry County",-,"401 - Carsley",24,25,8,0,57
"Surry County",-,"501 - Claremont",31,38,8,0,77
"Surry County",-,"502 - Spring Grove",5,6,0,0,11
"Surry County",-,Provisional,0,0,0,0,0
"Sussex County",-,"101 - Waverly",11,19,5,0,35
"Sussex County",-,"201 - Stony Creek",12,15,3,0,30
"Sussex County",-,"202 - Little Mill",4,0,1,0,5
"Sussex County",-,"301 - Courthouse",22,35,12,0,69
"Sussex County",-,"302 - Wakefield",21,18,6,0,45
"Sussex County",-,"401 - Mars Hill",18,24,13,0,55
"Sussex County",-,"402 - West Wakefield",0,1,0,0,1
"Sussex County",-,"501 - Henry",16,4,1,0,21
"Sussex County",-,"502 - Yale",5,7,1,0,13
"Sussex County",-,"601 - Blackwater",33,34,16,0,83
"Sussex County",-,"602 - Newville",7,10,4,0,21
"Sussex County",-,"AB - Central Absentee Precinct",4,3,2,0,9
"Sussex County",-,Provisional,0,0,0,0,0
"Tazewell County",-,"101 - Abbs Valley",6,8,1,0,15
"Tazewell County",-,"102 - Tip Top",13,16,7,0,36
"Tazewell County",-,"103 - Boissevain",1,11,2,0,14
"Tazewell County",-,"104 - Falls Mills",5,16,12,0,33
"Tazewell County",-,"106 - Pocahontas",1,1,4,0,6
"Tazewell County",-,"107 - Amonate",0,6,1,0,7
"Tazewell County",-,"109 - Bishop",0,13,2,0,15
"Tazewell County",-,"110 - Adria",7,10,7,0,24
"Tazewell County",-,"111 - Gap Store",6,19,3,0,28
"Tazewell County",-,"112 - Bandy",4,10,2,0,16
"Tazewell County",-,"203 - Burkes Garden",7,4,0,0,11
"Tazewell County",-,"204 - Clear Fork",2,15,4,0,21
"Tazewell County",-,"207 - Freestone",4,5,6,0,15
"Tazewell County",-,"209 - Jeffersonville",50,114,22,0,186
"Tazewell County",-,"214 - Thompson Valley",14,15,8,0,37
"Tazewell County",-,"301 - Cedar Bluff",20,77,29,0,126
"Tazewell County",-,"302 - Baptist Valley",3,8,3,0,14
"Tazewell County",-,"303 - Wardell",10,35,19,0,64
"Tazewell County",-,"305 - Pounding Mill",11,10,14,0,35
"Tazewell County",-,"401 - Richlands",35,83,24,0,142
"Tazewell County",-,"402 - Jewell Ridge",2,6,5,0,13
"Tazewell County",-,"404 - Raven",14,11,11,0,36
"Tazewell County",-,"501 - Springville",48,33,30,0,111
"Tazewell County",-,"502 - Graham",64,94,35,0,193
"Tazewell County",-,"Ab - Central Absentee Precinct",16,21,7,0,44
"Tazewell County",-,Provisional,0,0,0,0,0
"Virginia Beach City",-,"1 - North Beach",142,134,129,1,406
"Virginia Beach City",-,"2 - South Beach",64,71,41,0,176
"Virginia Beach City",-,"3 - Ocean Lakes",54,76,22,0,152
"Virginia Beach City",-,"4 - Linkhorn",140,99,82,0,321
"Virginia Beach City",-,"5 - Seatack",40,45,28,0,113
"Virginia Beach City",-,"6 - Alanton",144,113,134,0,391
"Virginia Beach City",-,"7 - Kingston",88,130,98,0,316
"Virginia Beach City",-,"8 - London Bridge",88,94,43,0,225
"Virginia Beach City",-,"9 - Trantwood",135,141,132,0,408
"Virginia Beach City",-,"10 - Great Neck",117,171,177,0,465
"Virginia Beach City",-,"11 - Cape Henry",100,98,106,0,304
"Virginia Beach City",-,"12 - Plaza",78,82,43,0,203
"Virginia Beach City",-,"13 - Mt Trashmore",164,129,59,0,352
"Virginia Beach City",-,"14 - Malibu",92,93,49,0,234
"Virginia Beach City",-,"15 - Old Donation",55,59,34,0,148
"Virginia Beach City",-,"16 - Aragona",78,153,31,0,262
"Virginia Beach City",-,"17 - Ocean Park",64,65,93,0,222
"Virginia Beach City",-,"18 - Thoroughgood",178,112,126,0,416
"Virginia Beach City",-,"19 - Lake Smith",74,83,32,0,189
"Virginia Beach City",-,"20 - Bayside",116,76,41,0,233
"Virginia Beach City",-,"21 - Davis Corner",31,31,20,0,82
"Virginia Beach City",-,"22 - Point O View",124,102,53,0,279
"Virginia Beach City",-,"23 - Arrowhead",116,105,66,0,287
"Virginia Beach City",-,"24 - Larkspur",76,71,48,0,195
"Virginia Beach City",-,"25 - Avalon",173,139,66,0,378
"Virginia Beach City",-,"26 - Fairfield",118,99,119,0,336
"Virginia Beach City",-,"27 - Edwin",149,145,81,0,375
"Virginia Beach City",-,"28 - Thalia",86,81,69,0,236
"Virginia Beach City",-,"29 - Holland",45,43,30,0,118
"Virginia Beach City",-,"30 - Red Wing",117,95,58,0,270
"Virginia Beach City",-,"31 - Sigma",178,166,104,0,448
"Virginia Beach City",-,"32 - Creeds",67,60,30,0,157
"Virginia Beach City",-,"33 - Capps Shop",51,104,34,0,189
"Virginia Beach City",-,"34 - Blackwater",35,47,19,0,101
"Virginia Beach City",-,"35 - Courthouse",179,177,169,0,525
"Virginia Beach City",-,"36 - Windsor Oaks",87,88,52,0,227
"Virginia Beach City",-,"37 - Chesapeake Beach",68,49,39,0,156
"Virginia Beach City",-,"38 - Witchduck",186,171,139,0,496
"Virginia Beach City",-,"39 - Pembroke",142,105,40,0,287
"Virginia Beach City",-,"40 - Bonney",58,77,28,0,163
"Virginia Beach City",-,"41 - College Park",72,46,44,0,162
"Virginia Beach City",-,"42 - Brandon",102,88,55,0,245
"Virginia Beach City",-,"43 - Bellamy",45,58,28,0,131
"Virginia Beach City",-,"44 - Centerville",124,101,97,0,322
"Virginia Beach City",-,"45 - Timberlake",50,34,33,0,117
"Virginia Beach City",-,"46 - Green Run",32,39,30,0,101
"Virginia Beach City",-,"47 - Kings Grant",220,153,128,0,501
"Virginia Beach City",-,"48 - Wolfsnare",113,107,102,0,322
"Virginia Beach City",-,"49 - Lynnhaven",145,134,134,0,413
"Virginia Beach City",-,"50 - Oceana",27,16,12,0,55
"Virginia Beach City",-,"51 - Stratford Chase",140,87,60,0,287
"Virginia Beach City",-,"52 - Homestead",132,133,105,0,370
"Virginia Beach City",-,"53 - Shannon",115,102,49,1,267
"Virginia Beach City",-,"54 - Cromwell",78,47,36,0,161
"Virginia Beach City",-,"55 - Magic Hollow",52,38,22,0,112
"Virginia Beach City",-,"56 - Edinburgh",70,56,39,0,165
"Virginia Beach City",-,"57 - Sherry Park",70,81,49,0,200
"Virginia Beach City",-,"58 - Glenwood",102,64,64,0,230
"Virginia Beach City",-,"59 - Shelton Park",76,46,36,0,158
"Virginia Beach City",-,"60 - Foxfire",94,99,74,0,267
"Virginia Beach City",-,"61 - Baker",12,13,13,0,38
"Virginia Beach City",-,"62 - Landstown",122,78,69,0,269
"Virginia Beach City",-,"63 - Culver",110,83,55,0,248
"Virginia Beach City",-,"64 - Rosemont Forest",141,109,88,0,338
"Virginia Beach City",-,"65 - Colonial",60,90,51,0,201
"Virginia Beach City",-,"66 - Hunt",78,79,74,0,231
"Virginia Beach City",-,"67 - Eastern Shore",24,15,18,0,57
"Virginia Beach City",-,"68 - Manor",147,118,76,0,341
"Virginia Beach City",-,"69 - Shell",50,41,27,0,118
"Virginia Beach City",-,"70 - Corporate Landing",88,72,31,0,191
"Virginia Beach City",-,"71 - Round Hill",51,28,27,0,106
"Virginia Beach City",-,"72 - Rudee",76,100,68,0,244
"Virginia Beach City",-,"73 - Dahlia",47,37,25,0,109
"Virginia Beach City",-,"74 - Buckner",41,43,19,0,103
"Virginia Beach City",-,"75 - Colony",139,106,137,0,382
"Virginia Beach City",-,"76 - Village",35,33,20,0,88
"Virginia Beach City",-,"77 - Brookwood",83,53,47,0,183
"Virginia Beach City",-,"78 - Indian Lakes",75,48,64,0,187
"Virginia Beach City",-,"79 - Pleasant Hall",41,31,26,0,98
"Virginia Beach City",-,"80 - Chimney Hill",39,49,43,0,131
"Virginia Beach City",-,"81 - Rock Lake",62,46,36,0,144
"Virginia Beach City",-,"82 - Shelburne",65,49,41,0,155
"Virginia Beach City",-,"83 - Strawbridge",122,71,72,0,265
"Virginia Beach City",-,"84 - Tallwood",66,55,45,0,166
"Virginia Beach City",-,"85 - Upton",101,82,91,0,274
"Virginia Beach City",-,"86 - Haygood",156,101,101,0,358
"Virginia Beach City",-,"87 - Hillcrest",110,68,61,0,239
"Virginia Beach City",-,"88 - North Landing",79,50,46,0,175
"Virginia Beach City",-,"89 - Lake Christopher",93,95,84,0,272
"Virginia Beach City",-,"90 - Lake Joyce",75,55,53,0,183
"Virginia Beach City",-,"91 - Lexington",65,47,32,0,144
"Virginia Beach City",-,"92 - Little Neck",133,104,97,0,334
"Virginia Beach City",-,"93 - Newtown",22,10,8,0,40
"Virginia Beach City",-,"94 - Pinewood",55,60,36,0,151
"Virginia Beach City",-,"95 - Dam Neck",29,44,18,0,91
"Virginia Beach City",-,"96 - Hilltop",38,43,27,0,108
"Virginia Beach City",-,"97 - Indian River",54,46,24,0,124
"Virginia Beach City",-,"98 - Independence",45,29,20,0,94
"Virginia Beach City",-,"Ab - Central Absentee Precinct",227,244,203,0,674
"Virginia Beach City",-,Provisional,6,4,3,0,13
"Warren County",-,"101 - Fork Town",91,37,13,0,141
"Warren County",-,"102 - Otterburn",152,66,30,0,248
"Warren County",-,"201 - Happy Creek",125,66,17,0,208
"Warren County",-,"202 - Linden",150,41,13,0,204
"Warren County",-,"301 - North River",90,22,21,0,133
"Warren County",-,"302 - Riverton",138,30,24,0,192
"Warren County",-,"401 - East Shenandoah",170,87,36,0,293
"Warren County",-,"402 - Town - West Shenandoah",91,38,25,0,154
"Warren County",-,"501 - South River",115,38,17,0,170
"Warren County",-,"502 - Bentonville",68,24,17,0,109
"Warren County",-,"504 - Browntown",76,16,6,0,98
"Warren County",-,"Ab - Central Absentee Precinct",38,6,7,0,51
"Warren County",-,Provisional,0,0,0,0,0
"Washington County",-,"101 - East Abingdon",52,73,27,0,152
"Washington County",-,"102 - West Abingdon",33,30,19,0,82
"Washington County",-,"201 - Clinchburg",22,25,32,0,79
"Washington County",-,"202 - Greendale",40,67,27,0,134
"Washington County",-,"203 - Hayters Gap",14,32,31,0,77
"Washington County",-,"204 Woodland Hills",40,69,32,0,141
"Washington County",-,"301 - Watauga",51,92,29,0,172
"Washington County",-,"302 - South Abingdon",63,45,30,0,138
"Washington County",-,"401 - Glade Spring",28,41,16,0,85
"Washington County",-,"402 - Meadowview",31,54,35,0,120
"Washington County",-,"501 - Rhea Valley",45,47,44,0,136
"Washington County",-,"502 - Damascus",21,26,16,0,63
"Washington County",-,"504 - Green Cove",9,7,9,0,25
"Washington County",-,"601 - Burson Place",33,41,29,0,103
"Washington County",-,"602 - Mendota",12,14,6,0,32
"Washington County",-,"603 - Valley Institute",35,37,40,0,112
"Washington County",-,"701 - High Point",52,35,18,0,105
"Washington County",-,"702 - Wallace",23,11,21,0,55
"Washington County",-,"703 - John Battle",33,43,29,0,105
"Washington County",-,"Ab - Central Absentee Precinct",21,24,13,0,58
"Washington County",-,Provisional,0,0,0,0,0
"Waynesboro City",-,"1 - Ward A",22,29,28,0,79
"Waynesboro City",-,"2 - Ward B",88,103,71,0,262
"Waynesboro City",-,"3 - Ward C",51,54,34,0,139
"Waynesboro City",-,"4 - Ward D",133,126,84,0,343
"Waynesboro City",-,"Ab - Central Absentee Precinct",9,14,9,0,32
"Waynesboro City",-,Provisional,0,0,0,0,0
"Westmoreland County",-,"101 - Precinct 1-1",34,17,15,0,66
"Westmoreland County",-,"102 - Precinct 1-2",17,12,2,0,31
"Westmoreland County",-,"201 - Precinct 2-1",85,39,20,0,144
"Westmoreland County",-,"202 - Precinct 2-2",52,30,7,0,89
"Westmoreland County",-,"301 - Precinct 3-1",35,29,14,0,78
"Westmoreland County",-,"302 - Precinct 3-2",17,19,7,0,43
"Westmoreland County",-,"401 - Precinct 4-1",84,80,27,0,191
"Westmoreland County",-,"501 - Precinct 5-1",95,58,28,0,181
"Westmoreland County",-,"Ab - Central Absentee Precinct",16,13,2,0,31
"Westmoreland County",-,Provisional,0,0,0,0,0
"Williamsburg City",-,"1 - Stryker",131,91,34,0,256
"Williamsburg City",-,"2 - Matoaka",117,101,36,0,254
"Williamsburg City",-,"Ab - Central Absentee Precinct",22,22,6,0,50
"Williamsburg City",-,Provisional,1,0,0,0,1
"Winchester City",-,"101 - Merrimans",201,35,19,0,255
"Winchester City",-,"102 - Old Town",170,22,15,0,207
"Winchester City",-,"201 - Virginia Avenue",88,4,7,0,99
"Winchester City",-,"301 - War Memorial",98,27,13,0,138
"Winchester City",-,"401 - Frederick Douglass",42,21,3,0,66
"Winchester City",-,"402 - Rolling Hills",169,33,12,0,214
"Winchester City",-,"Ab - Central Absentee Precinct",30,6,2,0,38
"Winchester City",-,Provisional,0,0,0,0,0
"Wise County",-,"101 - Appalachia",11,14,10,0,35
"Wise County",-,"102 - Dorchester",20,10,8,0,38
"Wise County",-,"103 - Guest River Voting Place",6,15,12,0,33
"Wise County",-,"104 - West Pound",21,27,20,0,68
"Wise County",-,"201 - North Coeburn",12,21,18,0,51
"Wise County",-,"202 - Wise",40,39,28,0,107
"Wise County",-,"203 - East Pound",10,3,6,0,19
"Wise County",-,"301 - Big Stone Gap",20,45,32,0,97
"Wise County",-,"302 - East Stone Gap",27,58,16,0,101
"Wise County",-,"401 - Clinch Valley",36,26,15,0,77
"Wise County",-,"402 - South Coeburn",19,38,29,0,86
"Wise County",-,"403 - St Paul",13,13,12,0,38
"Wise County",-,"Ab - Central Absentee Precinct",14,11,12,0,37
"Wise County",-,Provisional,0,0,0,0,0
"Wythe County",-,"101 - Royal Oak",11,17,5,0,33
"Wythe County",-,"102 - Rural Retreat",54,105,13,0,172
"Wythe County",-,"203 - West Wytheville",58,102,11,0,171
"Wythe County",-,"303 - East Wytheville",67,115,22,0,204
"Wythe County",-,"401 - Fort Chiswell",24,53,10,0,87
"Wythe County",-,"402 - Max Meadows",19,65,17,0,101
"Wythe County",-,"501 - Jackson Memorial",21,26,12,0,59
"Wythe County",-,"502 - Sheffey",14,78,12,0,104
"Wythe County",-,"601 - Huddle",15,18,7,0,40
"Wythe County",-,"602 - Zion",31,40,9,0,80
"Wythe County",-,"603 Evergreen",17,36,11,0,64
"Wythe County",-,"Ab - Central Absentee Precinct",9,18,4,0,31
"Wythe County",-,Provisional,0,0,0,0,0
"York County",-,"101 - Queens Lake",108,119,40,0,267
"York County",-,"102 - Waller Mill",105,144,44,0,293
"York County",-,"103 - Magruder",78,91,23,0,192
"York County",-,"201 - Coventry",180,154,50,0,384
"York County",-,"202 - Kiln Creek",88,70,31,0,189
"York County",-,"301 - Seaford",179,250,108,0,537
"York County",-,"302 - Yorktown",118,177,50,0,345
"York County",-,"303 - Edgehill",109,117,58,0,284
"York County",-,"401 - Harwoods Mill",194,191,89,0,474
"York County",-,"402 - Dare",186,196,71,0,453
"York County",-,"403 - Grafton",73,112,34,0,219
"York County",-,"501 - Tabb",175,164,132,0,471
"York County",-,"502 - Bethel",152,117,76,0,345
"York County",-,"Ab - Central Absentee Precinct",64,45,26,0,135
"York County",-,Provisional,1,1,0,0,2
TOTALS,,,"151,880","141,888","60,998",22,"354,788"
