County/City,Ward,Pct,"Corey Alan Stewart","Nicholas Jason Freitas","Earl Walker Jackson, Sr.","All Others","Total Votes Cast"
,,,,,
"Accomack County",-,"101 - Chincoteague",79,91,9,0,179
"Accomack County",-,"201 - Atlantic",45,47,7,0,99
"Accomack County",-,"202 - Greenbackville",59,63,14,0,136
"Accomack County",-,"301 - New Church",30,44,8,0,82
"Accomack County",-,"401 - Bloxom",27,19,5,0,51
"Accomack County",-,"402 - Parksley",33,65,8,0,106
"Accomack County",-,"403 - Saxis",19,14,1,0,34
"Accomack County",-,"501 - Mappsville",8,31,3,0,42
"Accomack County",-,"502 - Rue",4,12,1,0,17
"Accomack County",-,"601 - Accomac",51,74,1,0,126
"Accomack County",-,"602 - Tangier",51,26,5,0,82
"Accomack County",-,"701 - Nandua",81,115,9,0,205
"Accomack County",-,"801 - Bobtown",36,46,8,0,90
"Accomack County",-,"802 - Melfa",17,35,5,0,57
"Accomack County",-,"803 - Wachapreague",40,49,5,0,94
"Accomack County",-,"901 - Painter",75,93,7,0,175
"Accomack County",-,"Ab - Central Absentee Precinct",15,13,6,0,34
"Accomack County",-,Provisional,0,0,0,0,0
"Albemarle County",-,"101 - Woodbrook",50,102,18,0,170
"Albemarle County",-,"103 - Branchlands",30,10,9,0,49
"Albemarle County",-,"104 - Agnor-hurt",33,29,14,0,76
"Albemarle County",-,"105 - Dunlora",43,68,22,0,133
"Albemarle County",-,"106 - Northside",52,89,35,0,176
"Albemarle County",-,"201 - Jack Jouett",88,89,41,0,218
"Albemarle County",-,"202 - University Hall",7,29,4,0,40
"Albemarle County",-,"203 - Georgetown",15,26,16,0,57
"Albemarle County",-,"301 - Ivy",67,111,26,0,204
"Albemarle County",-,"302 - Red Hill",63,46,17,0,126
"Albemarle County",-,"304 - East Ivy",22,27,6,0,55
"Albemarle County",-,"305 - Country Green",29,41,13,0,83
"Albemarle County",-,"306 - Porters",46,27,17,0,90
"Albemarle County",-,"307 - Yellow Mountain",18,8,8,0,34
"Albemarle County",-,"401 - Scottsville",53,21,5,0,79
"Albemarle County",-,"402 - Monticello",46,31,6,0,83
"Albemarle County",-,"405 - Cale",36,44,23,0,103
"Albemarle County",-,"406 - Stone Robinson",104,103,31,0,238
"Albemarle County",-,"407 - Biscuit Run",13,26,8,0,47
"Albemarle County",-,"501 - Keswick",33,36,12,0,81
"Albemarle County",-,"502 - Stony Point",46,78,21,0,145
"Albemarle County",-,"503 - Hollymead",53,49,18,0,120
"Albemarle County",-,"504 - Free Bridge",37,40,10,0,87
"Albemarle County",-,"506 - Baker-butler",85,95,22,0,202
"Albemarle County",-,"507 - Pantops",50,58,16,0,124
"Albemarle County",-,"601 - Crozet",64,52,25,0,141
"Albemarle County",-,"602 - Free Union",40,25,13,0,78
"Albemarle County",-,"603 - Earlysville",80,87,44,0,211
"Albemarle County",-,"604 - Brownsville",50,47,10,0,107
"Albemarle County",-,"606 - Mechums River",58,60,17,0,135
"Albemarle County",-,"Ab - Central Absentee Precinct",43,47,14,0,104
"Albemarle County",-,Provisional,0,2,0,0,2
"Alexandria City",-,"101 - Ladrey Senior Building",42,31,7,0,80
"Alexandria City",-,"102 - City Hall",18,28,7,0,53
"Alexandria City",-,"103 - Lyles Crouch School",45,43,7,0,95
"Alexandria City",-,"104 - Durant Center",30,35,5,0,70
"Alexandria City",-,"105 - Lee Center",36,50,7,0,93
"Alexandria City",-,"106 - Cora Kelly",28,33,6,0,67
"Alexandria City",-,"107 - Mt Vernon Recreation Center",32,35,8,0,75
"Alexandria City",-,"108 - George Washington Middle Sch",34,49,4,0,87
"Alexandria City",-,"109 - Fire Department Headquarters",35,49,4,0,88
"Alexandria City",-,"110 - Charles Houston Center",26,55,7,0,88
"Alexandria City",-,"111 - Potomac Yard",17,26,6,0,49
"Alexandria City",-,"201 - Maury School",32,37,11,0,80
"Alexandria City",-,"202 - George Mason School",24,31,3,0,58
"Alexandria City",-,"203 - Agudas Achim Synagogue",29,31,8,0,68
"Alexandria City",-,"204 - Blessed Sacrament Church",14,47,6,0,67
"Alexandria City",-,"205 - Douglas Macarthur School",30,50,13,0,93
"Alexandria City",-,"206 - Chinquapin Park Recreation Ctr",25,27,3,0,55
"Alexandria City",-,"207 - Temple Beth El Synagogue",47,59,16,0,122
"Alexandria City",-,"208 - Nova Arts Center",27,27,4,0,58
"Alexandria City",-,"209 - James K Polk School",33,27,4,0,64
"Alexandria City",-,"210 - The Hermitage",25,24,7,0,56
"Alexandria City",-,"302 - Patrick Henry Rec Center",22,30,4,0,56
"Alexandria City",-,"303 - Charles E Beatley Library",34,26,8,0,68
"Alexandria City",-,"304 - Samuel Tucker School",28,29,9,0,66
"Alexandria City",-,"305 - John Adams School",23,19,9,0,51
"Alexandria City",-,"306 - William Ramsay School",21,15,9,0,45
"Alexandria City",-,"307 - South Port",39,22,9,0,70
"Alexandria City",-,"308 - Cameron Station Community Ctr",67,61,19,0,147
"Alexandria City",-,"Ab - Central Absentee Precinct",51,98,23,0,172
"Alexandria City",-,Provisional,0,1,0,0,1
"Alleghany County",-,"101 - Arritt",20,5,1,0,26
"Alleghany County",-,"103 - Dameron",9,6,3,0,18
"Alleghany County",-,"201 - Humpback Bridge",6,7,3,0,16
"Alleghany County",-,"202 - Dolly Ann",14,7,3,0,24
"Alleghany County",-,"301 - Callaghan",17,4,1,0,22
"Alleghany County",-,"302 - Griffith",23,17,8,0,48
"Alleghany County",-,"401 - Low Moor",22,8,1,0,31
"Alleghany County",-,"402 - Jackson Heights",19,8,5,0,32
"Alleghany County",-,"501 - Iron Gate",10,3,1,0,14
"Alleghany County",-,"502 - Peters Switch",34,15,3,0,52
"Alleghany County",-,"601 - District 1",18,21,3,0,42
"Alleghany County",-,"701 - District 2",18,11,0,0,29
"Alleghany County",-,"Ab - Central Absentee Precinct",1,3,0,0,4
"Alleghany County",-,Provisional,0,0,0,0,0
"Amelia County",-,"101 - Number One",41,82,5,0,128
"Amelia County",-,"201 - Number Two",49,93,2,0,144
"Amelia County",-,"301 - Number Three",51,112,5,0,168
"Amelia County",-,"401 - Number Four",42,140,7,0,189
"Amelia County",-,"501 - Number Five",62,121,5,0,188
"Amelia County",-,"Ab - Central Absentee Precinct",10,19,0,0,29
"Amelia County",-,Provisional,0,0,0,0,0
"Amherst County",-,"101 - Wright Shop",23,19,0,0,42
"Amherst County",-,"102 - New Glasgow",58,27,16,0,101
"Amherst County",-,"103 - Coolwell",27,21,8,0,56
"Amherst County",-,"201 - Court House",125,64,14,0,203
"Amherst County",-,"202 - Temperance",35,25,5,0,65
"Amherst County",-,"301 - Monroe",59,22,10,0,91
"Amherst County",-,"302 - Elon",121,58,19,0,198
"Amherst County",-,"303 - Pleasant View",11,27,5,0,43
"Amherst County",-,"401 - Amelon",88,74,18,0,180
"Amherst County",-,"402 - Lonco",24,14,9,0,47
"Amherst County",-,"501 - Madison",87,38,19,0,144
"Amherst County",-,"Ab - Central Absentee Precinct",19,14,11,0,44
"Amherst County",-,Provisional,0,0,0,0,0
"Appomattox County",-,"101 - Vera",33,33,2,0,68
"Appomattox County",-,"102 - Pamplin",60,24,14,0,98
"Appomattox County",-,"201 - Chap",22,11,5,0,38
"Appomattox County",-,"202 - Spout Spring",86,66,10,0,162
"Appomattox County",-,"301 - Us 460",50,38,7,0,95
"Appomattox County",-,"302 - Stonewall",69,34,9,0,112
"Appomattox County",-,"401 - Courthouse",82,53,9,0,144
"Appomattox County",-,"501 - Oakville",42,47,7,0,96
"Appomattox County",-,"502 - Agee",21,26,0,0,47
"Appomattox County",-,"Ab - Central Absentee Precinct",10,9,1,0,20
"Appomattox County",-,Provisional,0,0,0,0,0
"Arlington County",-,"1 - Arlington",14,19,6,0,39
"Arlington County",-,"2 - Ashton Heights",16,33,6,0,55
"Arlington County",-,"3 - Aurora Hills",40,44,3,0,87
"Arlington County",-,"4 - Ballston",25,39,9,0,73
"Arlington County",-,"5 - Barcroft",23,31,6,0,60
"Arlington County",-,"6 - Crystal City",17,32,14,0,63
"Arlington County",-,"7 - Cherrydale",26,35,11,0,72
"Arlington County",-,"8 - Hume",31,45,11,0,87
"Arlington County",-,"9 - Columbia",32,43,6,0,81
"Arlington County",-,"10 - Wilson",32,52,10,0,94
"Arlington County",-,"11 - East Falls Church",16,26,5,0,47
"Arlington County",-,"12 - Fairlington",37,60,11,0,108
"Arlington County",-,"13 - Glen Carlyn",20,15,6,0,41
"Arlington County",-,"14 - Clarendon",16,25,3,0,44
"Arlington County",-,"15 - Lyon Park",13,23,4,0,40
"Arlington County",-,"16 - Lyon Village",19,31,3,0,53
"Arlington County",-,"17 - Overlee Knolls",33,43,7,0,83
"Arlington County",-,"18 - Park Lane",24,69,2,0,95
"Arlington County",-,"19 - Rosslyn",30,51,10,0,91
"Arlington County",-,"20 - Thrifton",18,68,12,0,98
"Arlington County",-,"21 - Virginia Highlands",27,45,9,0,81
"Arlington County",-,"22 - Abingdon",45,64,7,0,116
"Arlington County",-,"23 - Westover",25,38,7,0,70
"Arlington County",-,"24 - Woodlawn",22,44,4,0,70
"Arlington County",-,"25 - Arlington Forest",40,40,7,0,87
"Arlington County",-,"26 - Fillmore",15,42,2,0,59
"Arlington County",-,"27 - Jefferson",27,23,1,0,51
"Arlington County",-,"28 - Wakefield",22,26,9,0,57
"Arlington County",-,"29 - Dominion Hills",19,32,6,0,57
"Arlington County",-,"30 - Glebe",16,19,6,0,41
"Arlington County",-,"31 - Lexington",30,40,7,0,77
"Arlington County",-,"32 - Oakridge",22,30,5,0,57
"Arlington County",-,"33 - Rock Spring",35,38,13,0,86
"Arlington County",-,"34 - Yorktown",18,47,5,0,70
"Arlington County",-,"35 - Madison",50,67,15,0,132
"Arlington County",-,"36 - Marshall",32,39,8,0,79
"Arlington County",-,"37 - Nottingham",18,31,3,0,52
"Arlington County",-,"38 - Arlington View",10,29,4,0,43
"Arlington County",-,"39 - Ashlawn",19,26,6,0,51
"Arlington County",-,"40 - Virginia Square",20,60,7,0,87
"Arlington County",-,"41 - Navy League",17,40,6,0,63
"Arlington County",-,"42 - Shirlington",17,26,3,0,46
"Arlington County",-,"43 - Campbell",4,9,1,0,14
"Arlington County",-,"44 - Dawson Terrace",14,25,5,0,44
"Arlington County",-,"45 - Buckingham",17,23,4,0,44
"Arlington County",-,"46 - Central",22,43,16,0,81
"Arlington County",-,"47 - Four Mile Run",13,18,7,0,38
"Arlington County",-,"48 - Ausa",14,27,3,0,44
"Arlington County",-,"49 - Monroe",6,20,6,0,32
"Arlington County",-,"50 - Crystal Plaza",24,49,9,0,82
"Arlington County",-,"51 - Taylor",29,12,7,0,48
"Arlington County",-,"52 - Gunston",10,22,0,0,32
"Arlington County",-,"53 - Met Park",19,46,7,0,72
"Arlington County",-,"54 - Garfield Park",15,24,3,0,42
"Arlington County",-,"Ab - Central Absentee Precinct",55,120,24,0,199
"Arlington County",-,Provisional,0,1,0,0,1
"Augusta County",-,"101 - Jolivue",55,23,9,0,87
"Augusta County",-,"102 - Stuarts Draft Elementary",49,24,9,0,82
"Augusta County",-,"103 - Verona",80,37,10,0,127
"Augusta County",-,"201 - Crimora",75,38,9,0,122
"Augusta County",-,"202 - New Hope",53,39,11,0,103
"Augusta County",-,"203 - Weyers Cave",72,42,30,0,144
"Augusta County",-,"301 - Fort Defiance",163,62,29,0,254
"Augusta County",-,"302 - North River",39,22,3,0,64
"Augusta County",-,"303 - Mount Solon",66,14,18,0,98
"Augusta County",-,"304 - Churchville Fire Station",51,22,10,0,83
"Augusta County",-,"401 - Buffalo Gap",60,22,10,0,92
"Augusta County",-,"402 - Churchville Elementary",61,31,8,0,100
"Augusta County",-,"403 - Craigsville",24,11,7,0,42
"Augusta County",-,"404 - Deerfield",38,4,1,0,43
"Augusta County",-,"405 - Cedar Green",69,37,21,0,127
"Augusta County",-,"501 - Greenville",73,38,14,0,125
"Augusta County",-,"502 - Middlebrook",53,18,7,0,78
"Augusta County",-,"503 - Spottswood",49,28,13,0,90
"Augusta County",-,"504 - White Hill",99,43,18,0,160
"Augusta County",-,"601 - Sherando",87,32,10,0,129
"Augusta County",-,"602 - Ridgeview",156,73,30,0,259
"Augusta County",-,"603 - Lyndhurst",90,50,17,0,157
"Augusta County",-,"801 - Dooms",84,46,2,0,132
"Augusta County",-,"802 - Fishersville",129,87,29,0,245
"Augusta County",-,"803 - Wilson",93,25,19,0,137
"Augusta County",-,"Ab - Central Absentee Precinct",38,29,13,0,80
"Augusta County",-,Provisional,0,0,0,0,0
"Bath County",-,"101 - Warm Springs",17,14,11,0,42
"Bath County",-,"102 - Mountain Grove",8,4,2,0,14
"Bath County",-,"201 - Hot Springs",12,8,6,0,26
"Bath County",-,"301 - Fairview",16,15,2,0,33
"Bath County",-,"302 - Burnsville",1,0,8,0,9
"Bath County",-,"401 - Millboro",14,9,1,0,24
"Bath County",-,"501 - Healing Springs",12,12,6,0,30
"Bath County",-,"Ab - Central Absentee Precinct",3,2,3,0,8
"Bath County",-,Provisional,0,0,0,0,0
"Bedford County",-,"101 - Goodview Elem School (CD 5)",86,40,11,0,137
"Bedford County",-,"102 - Hardy Vol Fire Co (CD 5)",39,16,12,0,67
"Bedford County",-,"103 - Chamblissburg Baptist Church (CD 5)",74,39,13,0,126
"Bedford County",-,"104 - Stewartsville Rescue Squad (CD 5)",57,20,11,0,88
"Bedford County",-,"201 - Bedford Christian Church (CD 5)",54,17,7,0,78
"Bedford County",-,"202 - Staunton River High School (CD 5)",49,36,15,0,100
"Bedford County",-,"203 - Moneta Elem School (CD 5)",76,83,16,0,175
"Bedford County",-,"204 - Quaker Baptist Church (CD 5)",37,20,5,0,62
"Bedford County",-,"205 - Saunders Vol Fire Co (CD 5)",88,82,14,0,184
"Bedford County",-,"301 - New London Academy (CD 6)",66,120,16,0,202
"Bedford County",-,"302 - Bedford Regional Water Auth (CD 5)",88,68,16,0,172
"Bedford County",-,"303 - Bethesda United Methodist Church (CD 5)",58,38,7,0,103
"Bedford County",-,"304 - The Well Church (CD 6)",50,44,2,0,96
"Bedford County",-,"305 - Huddleston Elem School (CD 5)",40,21,4,0,65
"Bedford County",-,"306 - Forest Fire Station #2 (CD 6)",78,49,13,0,140
"Bedford County",-,"401 - Forest Elementary School (CD 6)",85,120,10,0,215
"Bedford County",-,"402 - Thomas Jefferson Elem School (CD 6)",51,46,15,0,112
"Bedford County",-,"403 - Knights Of Columbus Bldg (CD 6)",99,110,14,0,223
"Bedford County",-,"404 - St. Paul Baptist Church (CD 6)",99,108,12,0,219
"Bedford County",-,"502 - Big Island Elem School (CD 6)",18,8,4,0,30
"Bedford County",-,"503 - Sedalia Center (CD 6)",41,17,7,0,65
"Bedford County",-,"504 - Suck Springs Baptist Church (CD 6)",89,25,11,0,125
"Bedford County",-,"505 - Boonsboro Elementary School (CD 6)",102,87,23,0,212
"Bedford County",-,"506 - Boonsboro Ruritan Club (CD 6)",92,98,22,0,212
"Bedford County",-,"601 - Montvale Elem School (CD 6)",78,43,9,0,130
"Bedford County",-,"602 - Shady Grove Fire Department (CD 5)",82,40,8,0,130
"Bedford County",-,"603 - Thaxton Baptist Church #1 (CD 5)",24,8,0,0,32
"Bedford County",-,"604 - Bedford Welcome Center (CD 5)",95,56,19,0,170
"Bedford County",-,"701 - Goode Vol Rescue Squad (CD 5)",139,75,16,0,230
"Bedford County",-,"702 - Liberty High School (CD 5)",88,38,10,0,136
"Bedford County",-,"703 - Thaxton Baptist Church #2 (CD 5)",68,30,14,0,112
"Bedford County",-,"704 - Bedford Central Library (CD 5)",92,45,9,0,146
"Bedford County",-,"Ab - Central Absentee Precinct (CD 5)",27,21,7,0,55
"Bedford County",-,"Ab - Central Absentee Precinct (CD 6)",11,25,6,0,42
"Bedford County",-,"Provisional (CD 5)",0,1,0,0,1
"Bedford County",-,"Provisional (CD 6)",0,0,0,0,0
"Bland County",-,"101 - Bastian",22,5,2,0,29
"Bland County",-,"102 - Ceres",14,4,6,0,24
"Bland County",-,"201 - Davis",12,3,0,0,15
"Bland County",-,"202 - Seddon",31,16,12,0,59
"Bland County",-,"301 - Hollybrook",15,6,2,0,23
"Bland County",-,"302 - Mechanicsburg",11,6,1,0,18
"Bland County",-,"401 - Rocky Gap",34,30,7,0,71
"Bland County",-,"Ab - Central Absentee Precinct",1,6,0,0,7
"Bland County",-,Provisional,0,0,0,0,0
"Botetourt County",-,"101 - Daleville",79,51,8,0,138
"Botetourt County",-,"102 - Greenfield",103,96,26,0,225
"Botetourt County",-,"201 - Blue Ridge",91,87,14,0,192
"Botetourt County",-,"202 - Rainbow Forest",75,70,10,0,155
"Botetourt County",-,"301 - Buchanan",48,44,11,0,103
"Botetourt County",-,"302 - Mill Creek",69,34,4,0,107
"Botetourt County",-,"403 - Eagle Rock",41,32,8,0,81
"Botetourt County",-,"406 - Fincastle",82,73,16,0,171
"Botetourt County",-,"501 - Troutville",45,38,6,0,89
"Botetourt County",-,"502 - Cloverdale",111,83,11,0,205
"Botetourt County",-,"Ab - Central Absentee Precinct",19,18,3,0,40
"Botetourt County",-,Provisional,0,0,0,0,0
"Bristol City",-,"1 - First Ward",51,15,2,0,68
"Bristol City",-,"2 - Second Ward",67,31,8,0,106
"Bristol City",-,"3 - Third Ward",29,7,3,0,39
"Bristol City",-,"4 - Fourth Ward",86,26,11,0,123
"Bristol City",-,"Ab - Central Absentee Precinct",5,7,1,0,13
"Bristol City",-,Provisional,0,0,0,0,0
"Brunswick County",-,"101 - Brodnax",14,12,0,0,26
"Brunswick County",-,"102 - Rock Store",13,9,5,0,27
"Brunswick County",-,"103 - Tillman",27,26,10,0,63
"Brunswick County",-,"201 - Dromgoole",0,4,0,0,4
"Brunswick County",-,"202 - Edgerton",5,15,1,0,21
"Brunswick County",-,"203 - Fitzhugh",9,8,2,0,19
"Brunswick County",-,"301 - Alberta",6,5,4,0,15
"Brunswick County",-,"302 - Danieltown",19,15,4,0,38
"Brunswick County",-,"303 - Elmore",8,5,0,0,13
"Brunswick County",-,"304 - Seymour",3,10,2,0,15
"Brunswick County",-,"401 - Sturgeon",10,12,7,0,29
"Brunswick County",-,"402 - King's Store",7,5,7,0,19
"Brunswick County",-,"501 - Totaro",12,14,3,0,29
"Brunswick County",-,"Ab - Central Absentee Precinct",5,3,1,0,9
"Brunswick County",-,Provisional,0,0,0,0,0
"Buchanan County",-,"102 - Blackey",3,11,0,0,14
"Buchanan County",-,"103 - Hurley",14,30,0,0,44
"Buchanan County",-,"201 - Grassy",3,0,0,0,3
"Buchanan County",-,"202 - Bull",13,3,0,0,16
"Buchanan County",-,"203 - Rocklick",5,9,1,0,15
"Buchanan County",-,"301 - Slate",9,6,0,0,15
"Buchanan County",-,"302 - North Grundy",6,14,2,0,22
"Buchanan County",-,"403 - South Grundy",15,18,0,0,33
"Buchanan County",-,"404 - Oakwood",3,1,0,0,4
"Buchanan County",-,"501 - Prater",2,1,0,0,3
"Buchanan County",-,"502 - Fox",0,0,2,0,2
"Buchanan County",-,"503 - Vansant",6,11,1,0,18
"Buchanan County",-,"601 - Council",3,0,0,0,3
"Buchanan County",-,"602 - Garden",4,10,0,0,14
"Buchanan County",-,"603 - Hurricane",2,6,0,0,8
"Buchanan County",-,"701 - Whitewood",9,11,1,0,21
"Buchanan County",-,"702 - Contrary",4,5,0,0,9
"Buchanan County",-,"Ab - Central Absentee Precinct",12,9,2,0,23
"Buchanan County",-,Provisional,0,0,0,0,0
"Buckingham County",-,"101 - New Canton",56,39,14,0,109
"Buckingham County",-,"102 - Georgia Creek",19,12,3,0,34
"Buckingham County",-,"201 - White Hall",25,30,5,0,60
"Buckingham County",-,"301 - Curdsville",23,42,17,0,82
"Buckingham County",-,"302 - New Store",42,29,4,0,75
"Buckingham County",-,"401 - Maysville",54,37,13,0,104
"Buckingham County",-,"501 - Wrights",24,33,4,0,61
"Buckingham County",-,"502 - Glenmore",39,22,12,0,73
"Buckingham County",-,"601 - Slate River",34,16,14,0,64
"Buckingham County",-,"701 - Gold Hill",31,29,11,0,71
"Buckingham County",-,"Ab - Central Absentee Precinct",12,20,3,0,35
"Buckingham County",-,Provisional,0,0,0,0,0
"Buena Vista City",-,"1 - First Ward",43,28,14,0,85
"Buena Vista City",-,"2 - Second Ward",29,26,5,0,60
"Buena Vista City",-,Provisional,0,0,0,0,0
"Campbell County",-,"101 - Brookville",121,90,20,0,231
"Campbell County",-,"102 - New London",131,59,16,0,206
"Campbell County",-,"201 - Walker",87,45,15,0,147
"Campbell County",-,"202 - Bedford Springs",90,81,22,0,193
"Campbell County",-,"301 - Evington",43,22,6,0,71
"Campbell County",-,"302 - Otter River",23,22,5,0,50
"Campbell County",-,"303 - Altavista",87,58,10,0,155
"Campbell County",-,"401 - Three Forks",96,41,6,0,143
"Campbell County",-,"402 - Court House",131,74,18,0,223
"Campbell County",-,"501 - Spring Hill",96,53,21,0,170
"Campbell County",-,"502 - Yellow Branch",68,26,7,0,101
"Campbell County",-,"601 - Kings",59,45,10,0,114
"Campbell County",-,"602 - Concord",89,58,18,0,165
"Campbell County",-,"701 - Brookneal",46,43,10,0,99
"Campbell County",-,"702 - Gladys",78,48,10,0,136
"Campbell County",-,"703 - Morris Church",31,34,1,0,66
"Campbell County",-,"Ab - Central Absentee Precinct",29,27,9,0,65
"Campbell County",-,Provisional,0,0,0,0,0
"Caroline County",-,"101 - Bowling Green",23,141,6,0,170
"Caroline County",-,"102 - Sparta",22,88,9,0,119
"Caroline County",-,"201 - North Madison",37,36,2,0,75
"Caroline County",-,"202 - South Madison",25,67,4,0,96
"Caroline County",-,"301 - Port Royal",31,21,2,0,54
"Caroline County",-,"302 - Woodford",35,67,8,0,110
"Caroline County",-,"401 - Dawn",38,41,5,0,84
"Caroline County",-,"402 - Carmel Church",14,21,1,0,36
"Caroline County",-,"501 - West Mattaponi",31,33,1,0,65
"Caroline County",-,"502 - Milford",29,43,2,0,74
"Caroline County",-,"601 - Chilesburg",29,65,7,0,101
"Caroline County",-,"602 - Lake",16,42,8,0,66
"Caroline County",-,"Ab - Central Absentee Precinct",22,30,3,0,55
"Caroline County",-,Provisional,0,0,0,0,0
"Carroll County",-,"101 - Mt Bethel",26,1,2,0,29
"Carroll County",-,"102 - St Paul",34,16,7,0,57
"Carroll County",-,"103 - Lambsburg",19,3,4,0,26
"Carroll County",-,"105 - Fancy Gap",26,25,1,0,52
"Carroll County",-,"201 - Hillsville B",57,26,9,1,93
"Carroll County",-,"202 - Laurel Fork",23,11,6,0,40
"Carroll County",-,"203 - Gladesboro",26,18,3,0,47
"Carroll County",-,"301 - Hillsville C",54,21,9,0,84
"Carroll County",-,"302 - Sylvatus",21,15,3,0,39
"Carroll County",-,"303 - Dugspur",14,6,2,0,22
"Carroll County",-,"401 - Oakland",62,13,8,0,83
"Carroll County",-,"402 - Woodlawn D",50,26,4,0,80
"Carroll County",-,"406 - Woodlawn F",1,8,2,0,11
"Carroll County",-,"501 - Vaughan",33,9,5,0,47
"Carroll County",-,"502 - Gladeville",32,30,6,0,68
"Carroll County",-,"503 - Woodlawn E",23,15,1,0,39
"Carroll County",-,"504 - Laurel",14,6,2,0,22
"Carroll County",-,"Ab - Central Absentee Precinct",15,14,6,0,35
"Carroll County",-,Provisional,0,0,0,0,0
"Charles City County",-,"101 - Precinct 1-1",38,38,17,0,93
"Charles City County",-,"201 - Precinct 2-1",22,38,14,0,74
"Charles City County",-,"301 - Precinct 3-1",44,41,29,0,114
"Charles City County",-,"Ab - Central Absentee Precinct",3,3,2,0,8
"Charles City County",-,Provisional,0,0,0,0,0
"Charlotte County",-,"101 - County Seat",27,49,11,0,87
"Charlotte County",-,"201 - Red Oak Wylliesburg",26,23,0,0,49
"Charlotte County",-,"302 - Drakes Branch",26,15,3,0,44
"Charlotte County",-,"401 - Keysville",27,24,6,0,57
"Charlotte County",-,"501 - Cullen/Red House",23,21,16,0,60
"Charlotte County",-,"602 - Phenix",21,33,11,0,65
"Charlotte County",-,"702 - Bacon/Saxe",16,12,4,0,32
"Charlotte County",-,"Ab - Central Absentee Precinct",2,4,0,0,6
"Charlotte County",-,Provisional,0,0,0,0,0
"Charlottesville City",-,"101 - Recreation",32,48,16,0,96
"Charlottesville City",-,"102 - Clark",19,35,18,0,72
"Charlottesville City",-,"201 - Carver",13,26,18,1,58
"Charlottesville City",-,"202 - Walker",42,44,24,0,110
"Charlottesville City",-,"301 - Benjamin Tonsler",7,41,14,0,62
"Charlottesville City",-,"302 - Johnson",35,60,16,0,111
"Charlottesville City",-,"303 - Buford",6,21,6,0,33
"Charlottesville City",-,"401 - Venable",0,17,2,0,19
"Charlottesville City",-,"402 - Alumni Hall",16,34,7,0,57
"Charlottesville City",-,"Ab - Central Absentee Precinct",11,35,9,0,55
"Charlottesville City",-,Provisional,0,0,0,0,0
"Chesapeake City",-,"1 - Great Bridge (CD 4)",55,68,51,0,174
"Chesapeake City",-,"2 - Bethel (CD 4)",43,96,42,0,181
"Chesapeake City",-,"3 - Camelot (CD 3)",5,7,21,0,33
"Chesapeake City",-,"4 - Churchland (CD 3)",39,53,33,0,125
"Chesapeake City",-,"5 - Crestwood (CD 3)",7,11,14,0,32
"Chesapeake City",-,"6 - Deep Creek (CD 4)",75,81,59,0,215
"Chesapeake City",-,"7 - Greenbrier (CD 4)",65,75,58,0,198
"Chesapeake City",-,"8 - South Norfolk Recreation (CD 3)",53,53,40,0,146
"Chesapeake City",-,"9 - Bells Mill (CD 4)",103,151,70,0,324
"Chesapeake City",-,"10 - Oscar Smith (CD 3)",26,22,15,0,63
"Chesapeake City",-,"11 - Geneva Park (CD 3)",36,36,26,0,98
"Chesapeake City",-,"12 - Georgetown (CD 3)",11,9,17,0,37
"Chesapeake City",-,"13 - Gilmerton (CD 3)",36,42,36,0,114
"Chesapeake City",-,"14 - Grassfield (CD 4)",28,22,10,0,60
"Chesapeake City",-,"15 - B M Williams (CD 3)",24,31,29,0,84
"Chesapeake City",-,"16 - Hickory Grove (CD 4)",69,98,40,0,207
"Chesapeake City",-,"17 - Indian Creek (CD 4)",51,58,30,0,139
"Chesapeake City",-,"18 - Indian River (CD 3)",19,29,17,0,65
"Chesapeake City",-,"19 - Jolliff (CD 4)",37,48,26,0,111
"Chesapeake City",-,"20 - E W Chittum (CD 3)",0,0,0,0,0
"Chesapeake City",-,"20 - E W Chittum (CD 4)",46,39,36,0,121
"Chesapeake City",-,"21 - Fellowship (CD 3)",57,54,32,0,143
"Chesapeake City",-,"22 - Norfolk Highlands (CD 3)",35,42,34,0,111
"Chesapeake City",-,"23 - Oak Grove (CD 4)",42,56,45,0,143
"Chesapeake City",-,"24 - Oaklette (CD 3)",32,23,21,0,76
"Chesapeake City",-,"25 - St Julians (CD 3)",22,19,15,0,56
"Chesapeake City",-,"26 - Johnson Park (CD 3)",20,14,15,0,49
"Chesapeake City",-,"27 - Silverwood (CD 3)",79,68,51,0,198
"Chesapeake City",-,"28 - Sunray I (CD 4)",26,12,4,0,42
"Chesapeake City",-,"29 - Tanglewood (CD 3)",50,45,60,0,155
"Chesapeake City",-,"30 - South Norfolk (CD 3)",2,1,0,0,3
"Chesapeake City",-,"31 - Carver School (CD 3)",15,10,13,0,38
"Chesapeake City",-,"32 - Providence (CD 3)",9,2,11,1,23
"Chesapeake City",-,"33 - Westover (CD 3)",44,27,33,0,104
"Chesapeake City",-,"34 - Hickory Middle School (CD 4)",72,121,68,0,261
"Chesapeake City",-,"35 - Taylor Road (CD 3)",23,20,11,0,54
"Chesapeake City",-,"36 - Great Bridge Baptist Church (CD 4)",80,109,64,0,253
"Chesapeake City",-,"37 - Bridgetown (CD 4)",48,60,35,0,143
"Chesapeake City",-,"38 - Bailey Creek (CD 3)",73,58,30,0,161
"Chesapeake City",-,"39 - Lake Drummond (CD 4)",24,29,18,0,71
"Chesapeake City",-,"40 - River Birch (CD 3)",40,53,32,0,125
"Chesapeake City",-,"41 - John T West (CD 4)",73,72,41,0,186
"Chesapeake City",-,"42 - Parkways (CD 3)",22,44,23,0,89
"Chesapeake City",-,"43 - Pleasant Crossing (CD 4)",75,62,42,0,179
"Chesapeake City",-,"44 - Nansemond (CD 3)",33,27,20,0,80
"Chesapeake City",-,"45 - Sunray II (CD 4)",7,12,11,0,30
"Chesapeake City",-,"46 - Bells Mill II (CD 4)",43,64,31,0,138
"Chesapeake City",-,"47 - Green Sea (CD 4)",35,35,22,0,92
"Chesapeake City",-,"48 - Jolliff Middle School (CD 4)",13,8,18,0,39
"Chesapeake City",-,"49 - Waterway (CD 4)",101,99,85,0,285
"Chesapeake City",-,"50 - River Walk (CD 4)",39,51,44,0,134
"Chesapeake City",-,"51 - Coopers Way (CD 4)",64,110,52,0,226
"Chesapeake City",-,"52 - Shipyard Road (CD 4)",44,41,33,0,118
"Chesapeake City",-,"53 - Fairways (CD 3)",30,36,29,0,95
"Chesapeake City",-,"54 - Pughsville (CD 3)",30,18,15,0,63
"Chesapeake City",-,"55 - Georgetown East (CD 3)",20,16,13,0,49
"Chesapeake City",-,"56 - Green Tree (CD 3)",21,28,23,0,72
"Chesapeake City",-,"57 - Cypress (CD 3)",28,40,38,0,106
"Chesapeake City",-,"58 - Expressway (CD 4)",13,10,7,0,30
"Chesapeake City",-,"59 - Clearfield (CD 4)",38,41,56,0,135
"Chesapeake City",-,"60 - Parker Road (CD 4)",64,66,40,0,170
"Chesapeake City",-,"61 - Centerville (CD 4)",60,71,35,0,166
"Chesapeake City",-,"62 - Fentress (CD 4)",68,85,38,0,191
"Chesapeake City",-,"63 - Poplar Branch (CD 4)",36,39,18,0,93
"Chesapeake City",-,"AB - Central Absentee Precinct (CD 3)",28,19,27,0,74
"Chesapeake City",-,"Ab - Central Absentee Precinct (CD 4)",59,41,43,0,143
"Chesapeake City",-,"Provisional (CD 3)",0,0,1,0,1
"Chesapeake City",-,"Provisional (CD 4)",0,2,1,0,3
"Chesterfield County",-,"101 - Bellwood (CD 4)",69,35,20,0,124
"Chesterfield County",-,"102 - South Chester (CD 4)",104,108,43,0,255
"Chesterfield County",-,"103 - Enon (CD 4)",113,106,14,0,233
"Chesterfield County",-,"104 - North Chester (CD 4)",134,145,39,0,318
"Chesterfield County",-,"105 - Drewrys Bluff (CD 7)",52,43,6,0,101
"Chesterfield County",-,"106 - Harrowgate (CD 4)",134,124,53,0,311
"Chesterfield County",-,"107 - Wells (CD 4)",78,119,29,0,226
"Chesterfield County",-,"108 - Ecoff (CD 4)",212,287,43,0,542
"Chesterfield County",-,"109 - Elizabeth Scott (CD 4)",117,161,29,0,307
"Chesterfield County",-,"110 - Dutch Gap (CD 4)",67,79,19,0,165
"Chesterfield County",-,"111 - Iron Bridge (CD 4)",181,204,76,0,461
"Chesterfield County",-,"112 - Carver (CD 4)",83,80,30,0,193
"Chesterfield County",-,"201 - Gates (CD 4)",113,85,41,0,239
"Chesterfield County",-,"202 - Beulah (CD 7)",81,64,9,0,154
"Chesterfield County",-,"203 - Bird (CD 4)",21,15,7,0,43
"Chesterfield County",-,"204 - Jacobs (CD 7)",43,61,8,0,112
"Chesterfield County",-,"205 - Falling Creek (CD 7)",80,66,7,0,153
"Chesterfield County",-,"206 - Belmont (CD 7)",24,15,1,0,40
"Chesterfield County",-,"207 - Chippenham (CD 7)",12,22,5,0,39
"Chesterfield County",-,"208 - Meadowbrook (CD 7)",61,39,5,0,105
"Chesterfield County",-,"209 - Salem Church (CD 4)",120,96,35,0,251
"Chesterfield County",-,"210 - Five Forks (CD 7)",75,81,20,0,176
"Chesterfield County",-,"211 - Nash (CD 4)",196,280,63,0,539
"Chesterfield County",-,"212 - St. Luke's (CD 7)",59,78,12,0,149
"Chesterfield County",-,"213 - Southside (CD 7)",58,54,10,0,122
"Chesterfield County",-,"214 - Hopkins (CD 7)",2,3,2,0,7
"Chesterfield County",-,"215 - North Bird (CD 7)",24,17,7,0,48
"Chesterfield County",-,"301 - Ettrick (CD 4)",31,23,19,0,73
"Chesterfield County",-,"302 - Deer Run (CD 7)",32,46,11,0,89
"Chesterfield County",-,"303 - Matoaca (CD 4)",119,69,40,0,228
"Chesterfield County",-,"304 - Winfrees Store (CD 4)",168,173,34,0,375
"Chesterfield County",-,"305 - Beach (CD 4)",73,70,25,0,168
"Chesterfield County",-,"306 - Winterpock (CD 7)",161,166,33,0,360
"Chesterfield County",-,"307 - Cosby (CD 7)",85,118,16,0,219
"Chesterfield County",-,"308 - South Manchester (CD 7)",13,28,6,0,47
"Chesterfield County",-,"309 - Skinquarter (CD 7)",143,189,38,0,370
"Chesterfield County",-,"310 - Tomahawk (CD 7)",104,179,22,0,305
"Chesterfield County",-,"313 - Woolridge (CD 7)",101,183,13,0,297
"Chesterfield County",-,"315 - Bailey Bridge (CD 7)",102,161,35,0,298
"Chesterfield County",-,"316 - Spring Run (CD 7)",58,90,16,0,164
"Chesterfield County",-,"317 - Birkdale (CD 7)",100,183,36,0,319
"Chesterfield County",-,"318 - West Beach (CD 7)",39,32,12,0,83
"Chesterfield County",-,"401 - Harbour Pointe (CD 7)",36,106,9,1,152
"Chesterfield County",-,"402 - Genito (CD 7)",79,126,23,0,228
"Chesterfield County",-,"403 - Brandermill (CD 7)",96,160,8,0,264
"Chesterfield County",-,"404 - Providence (CD 7)",69,120,28,0,217
"Chesterfield County",-,"405 - La Prade (CD 7)",107,145,20,0,272
"Chesterfield County",-,"406 - Smoketree (CD 7)",88,157,16,0,261
"Chesterfield County",-,"407 - Monacan (CD 7)",58,77,13,0,148
"Chesterfield County",-,"408 - Reams (CD 7)",69,113,10,0,192
"Chesterfield County",-,"409 - Manchester (CD 7)",62,95,9,0,166
"Chesterfield County",-,"410 - Wagstaff (CD 7)",59,59,8,0,126
"Chesterfield County",-,"411 - Swift Creek (CD 7)",80,142,17,0,239
"Chesterfield County",-,"413 - Shenandoah (CD 7)",64,140,18,0,222
"Chesterfield County",-,"414 - Crenshaw (CD 7)",98,116,26,0,240
"Chesterfield County",-,"415 - Evergreen (CD 7)",60,108,18,0,186
"Chesterfield County",-,"416 - Evergreen West (CD 7)",30,54,8,0,92
"Chesterfield County",-,"417 - Edgewater (CD 7)",44,46,12,0,102
"Chesterfield County",-,"501 - Huguenot (CD 7)",59,121,13,0,193
"Chesterfield County",-,"502 - Crestwood (CD 7)",33,110,6,0,149
"Chesterfield County",-,"503 - Midlothian (CD 7)",87,113,10,0,210
"Chesterfield County",-,"504 - Robious (CD 7)",121,252,27,0,400
"Chesterfield County",-,"505 - Bon Air (CD 7)",72,139,17,0,228
"Chesterfield County",-,"506 - Greenfield (CD 7)",52,134,15,1,202
"Chesterfield County",-,"507 - Salisbury (CD 7)",104,233,23,0,360
"Chesterfield County",-,"508 - Belgrade (CD 7)",83,131,7,0,221
"Chesterfield County",-,"509 - Cranbeck (CD 7)",45,70,13,0,128
"Chesterfield County",-,"510 - Sycamore (CD 7)",81,147,23,0,251
"Chesterfield County",-,"511 - Black Heath (CD 7)",53,129,13,0,195
"Chesterfield County",-,"513 - Beaufont (CD 7)",14,26,4,0,44
"Chesterfield County",-,"514 - Watkins (CD 7)",97,175,21,1,294
"Chesterfield County",-,"515 - Davis (CD 7)",15,17,9,0,41
"Chesterfield County",-,"516 - Pocoshock (CD 7)",18,13,5,0,36
"Chesterfield County",-,"517 - Roseland (CD 7)",33,60,8,0,101
"Chesterfield County",-,"518 - Midlothian North (CD 7)",69,201,11,0,281
"Chesterfield County",-,"Ab - Central Absentee Precinct (CD 4)",61,31,13,0,105
"Chesterfield County",-,"Ab - Central Absentee Precinct (CD 7)",75,104,14,0,193
"Chesterfield County",-,"Provisional (CD 4)",0,1,0,0,1
"Chesterfield County",-,"Provisional (CD 7)",1,0,0,0,1
"Clarke County",-,"101 - Russell",196,68,45,0,309
"Clarke County",-,"201 - Berryville",119,53,28,0,200
"Clarke County",-,"301 - Millwood",96,38,24,0,158
"Clarke County",-,"302 - Pine Grove",57,17,10,0,84
"Clarke County",-,"401 - White Post",155,45,36,0,236
"Clarke County",-,"501 - Buckmarsh",118,39,18,0,175
"Clarke County",-,"502 - Blue Ridge",40,27,2,0,69
"Clarke County",-,"Ab - Central Absentee Precinct",30,18,4,0,52
"Clarke County",-,Provisional,0,0,0,0,0
"Colonial Heights City",-,"1 - First",33,45,10,0,88
"Colonial Heights City",-,"2 - Second",65,48,13,0,126
"Colonial Heights City",-,"3 - Third",86,107,14,0,207
"Colonial Heights City",-,"4 - Fourth",88,123,16,0,227
"Colonial Heights City",-,"5 - Fifth",93,182,16,0,291
"Colonial Heights City",-,"Ab - Central Absentee Precinct",10,8,3,0,21
"Colonial Heights City",-,Provisional,0,0,0,0,0
"Covington City",-,"101 - Precinct 1-1",10,6,3,0,19
"Covington City",-,"201 - Precinct 2-1",4,6,2,0,12
"Covington City",-,"301 - Precinct 3-1",1,2,1,0,4
"Covington City",-,"401 - Precinct 4-1",21,10,3,0,34
"Covington City",-,"501 - Precinct 5-1",18,5,5,0,28
"Covington City",-,"Ab - Central Absentee Precinct",4,0,0,0,4
"Covington City",-,Provisional,0,0,0,0,0
"Craig County",-,"101 - Court House",28,53,3,0,84
"Craig County",-,"201 - Ammendale Precinct",16,71,4,0,91
"Craig County",-,"301 - Givens & Reynolds Store",16,13,2,0,31
"Craig County",-,"303 - Marshalls Store",13,3,3,0,19
"Craig County",-,"401 - Barbours Creek",11,13,1,0,25
"Craig County",-,"402 - Paint Bank",1,4,1,0,6
"Craig County",-,"403 - Craig Springs",1,17,1,0,19
"Craig County",-,"501 - Craig City",11,32,0,0,43
"Craig County",-,Provisional,0,0,0,0,0
"Culpeper County",-,"101 - West Fairfax",39,294,9,0,342
"Culpeper County",-,"201 - East Fairfax",29,150,5,0,184
"Culpeper County",-,"302 - Eggbornsville",33,185,1,0,219
"Culpeper County",-,"303 - Cardova",44,149,3,0,196
"Culpeper County",-,"304 - Willow Shade",16,40,0,0,56
"Culpeper County",-,"401 - Eldorado",36,195,12,0,243
"Culpeper County",-,"402 - Browns Store",74,319,8,0,401
"Culpeper County",-,"501 - Jeffersonton",84,164,6,0,254
"Culpeper County",-,"502 - Rixeyville",91,182,12,0,285
"Culpeper County",-,"601 - Mitchells",14,48,2,0,64
"Culpeper County",-,"602 - Pearl Sample",46,290,4,0,340
"Culpeper County",-,"603 - South Ridge",11,67,1,0,79
"Culpeper County",-,"702 - Brandy Station",58,299,2,0,359
"Culpeper County",-,"703 - Lignum",29,111,1,0,141
"Culpeper County",-,"704 - Richardsville",19,64,1,0,84
"Culpeper County",-,"Ab - Central Absentee Precinct",29,94,2,0,125
"Culpeper County",-,Provisional,0,1,0,0,1
"Cumberland County",-,"101 - Precinct 1",69,57,14,0,140
"Cumberland County",-,"201 - Precinct 2",47,84,11,0,142
"Cumberland County",-,"301 - Precinct 3",12,32,12,0,56
"Cumberland County",-,"401 - Precinct 4",40,62,7,0,109
"Cumberland County",-,"501 - Precinct 5",32,41,12,0,85
"Cumberland County",-,"Ab - Central Absentee Precinct",2,6,1,0,9
"Cumberland County",-,Provisional,0,0,0,0,0
"Danville City",-,"1 - Ward One",1,4,1,0,6
"Danville City",-,"2 - Ward Two",10,15,4,0,29
"Danville City",-,"3 - Ward Three",13,24,13,0,50
"Danville City",-,"4 - Ward Four",57,34,11,0,102
"Danville City",-,"6 - Ward Six",9,4,0,0,13
"Danville City",-,"7 - Ward Seven",7,8,7,0,22
"Danville City",-,"8 - Ward Eight",16,11,7,0,34
"Danville City",-,"9 - Ward Nine",39,11,14,0,64
"Danville City",-,"10 - Ward Ten",38,25,7,0,70
"Danville City",-,"11 - Ward Eleven",43,9,13,0,65
"Danville City",-,"12 - Ward Twelve",50,33,18,0,101
"Danville City",-,"13 - Ward Thirteen",33,27,9,0,69
"Danville City",-,"14 - Ward Fourteen",0,0,2,0,2
"Danville City",-,"15 - Ward Fifteen",39,20,13,0,72
"Danville City",-,"16 - Ward Sixteen",79,26,17,0,122
"Danville City",-,"17 - Ward Seventeen",57,45,11,0,113
"Danville City",-,"Ab - Central Absentee Precinct",16,10,5,0,31
"Danville City",-,Provisional,0,0,0,0,0
"Dickenson County",-,"101 - South Clintwood",22,6,6,0,34
"Dickenson County",-,"201 - Nora",5,2,0,0,7
"Dickenson County",-,"202 - Frying Pan",3,1,0,0,4
"Dickenson County",-,"203 - Clinchco",7,2,3,0,12
"Dickenson County",-,"301 - West Dante",13,0,0,0,13
"Dickenson County",-,"302 - Herald",21,5,1,0,27
"Dickenson County",-,"303 - Ridge",9,2,3,0,14
"Dickenson County",-,"401 - Haysi-colley",11,0,3,0,14
"Dickenson County",-,"501 - Tarpon",9,2,1,0,12
"Dickenson County",-,"502 - North Clintwood",17,9,0,0,26
"Dickenson County",-,"Ab - Central Absentee Precinct",16,3,4,0,23
"Dickenson County",-,Provisional,0,0,0,0,0
"Dinwiddie County",-,"101 - White Oak",35,16,2,0,53
"Dinwiddie County",-,"102 - Rocky Run",42,36,0,0,78
"Dinwiddie County",-,"103 - Church Road",75,65,12,0,152
"Dinwiddie County",-,"201 - Rohoic",20,10,9,0,39
"Dinwiddie County",-,"202 - Sutherland",78,56,9,0,143
"Dinwiddie County",-,"301 - Reams",34,23,1,0,58
"Dinwiddie County",-,"302 - New Hope",58,30,13,0,101
"Dinwiddie County",-,"303 - Little Zion",25,34,14,0,73
"Dinwiddie County",-,"401 - Dinwiddie",61,48,10,0,119
"Dinwiddie County",-,"402 - Mckenney",29,13,5,0,47
"Dinwiddie County",-,"403 - Cherry Hill",23,15,1,0,39
"Dinwiddie County",-,"501 - Edgehill",8,5,4,0,17
"Dinwiddie County",-,"502 - Chesdin",55,35,7,0,97
"Dinwiddie County",-,"Ab - Central Absentee Precinct",16,14,3,0,33
"Dinwiddie County",-,Provisional,0,0,0,0,0
"Emporia City",-,"101 - Precinct 1-1",4,2,1,0,7
"Emporia City",-,"201 - Precinct 2-1",1,1,0,0,2
"Emporia City",-,"301 - Precinct 3-1",11,5,5,0,21
"Emporia City",-,"401 - Precinct 4-1",9,10,2,0,21
"Emporia City",-,"501 - Precinct 5-1",1,0,0,0,1
"Emporia City",-,"601 - District 6",8,16,3,0,27
"Emporia City",-,"701 - District 7",10,3,0,0,13
"Emporia City",-,"AB - Central Absentee Precinct",2,0,0,0,2
"Emporia City",-,Provisional,0,0,0,0,0
"Essex County",-,"101 - Greater Tappahannock",33,34,5,0,72
"Essex County",-,"201 - North",23,27,6,0,56
"Essex County",-,"301 - South",65,76,13,0,154
"Essex County",-,"401 - Central",40,53,10,0,103
"Essex County",-,"Ab - Central Absentee Precinct",6,5,0,0,11
"Essex County",-,Provisional,0,0,0,0,0
"Fairfax County",-,"104 - Chapel (CD 11)",100,55,17,0,172
"Fairfax County",-,"105 - Fairview (CD 11)",109,107,36,0,252
"Fairfax County",-,"106 - Heritage (CD 11)",36,33,22,0,91
"Fairfax County",-,"108 - Kings Park (CD 11)",87,46,18,0,151
"Fairfax County",-,"109 - Little Run (CD 11)",42,36,16,0,94
"Fairfax County",-,"110 - North Springfield (CD 11)",97,83,41,0,221
"Fairfax County",-,"113 - Canterbury (CD 11)",89,89,19,0,197
"Fairfax County",-,"114 - Olde Creek (CD 11)",60,32,14,0,106
"Fairfax County",-,"115 - Ravensworth (CD 11)",50,40,14,0,104
"Fairfax County",-,"116 - Wakefield (CD 11)",48,31,15,0,94
"Fairfax County",-,"117 - Woodson (CD 11)",55,57,15,0,127
"Fairfax County",-,"118 - Lake Braddock (CD 11)",85,49,18,0,152
"Fairfax County",-,"119 - Laurel (CD 11)",106,65,40,0,211
"Fairfax County",-,"120 - Sideburn (CD 11)",90,92,33,0,215
"Fairfax County",-,"121 - Villa (CD 11)",39,37,20,0,96
"Fairfax County",-,"123 - Robinson (CD 11)",95,72,19,0,186
"Fairfax County",-,"125 - Signal Hill (CD 11)",62,61,26,0,149
"Fairfax County",-,"126 - Bonnie Brae (CD 11)",58,49,18,0,125
"Fairfax County",-,"127 - Burke Centre (CD 11)",99,73,25,0,197
"Fairfax County",-,"128 - Cardinal (CD 11)",66,48,33,0,147
"Fairfax County",-,"129 - Keene Mill (CD 11)",40,34,15,0,89
"Fairfax County",-,"130 - Terra Centre (CD 11)",65,44,12,0,121
"Fairfax County",-,"131 - Eagle View (CD 11)",79,43,13,0,135
"Fairfax County",-,"132 - Monument (CD 11)",48,41,19,0,108
"Fairfax County",-,"133 - Danbury (CD 11)",12,11,8,0,31
"Fairfax County",-,"134 - University (CD 11)",9,12,7,0,28
"Fairfax County",-,"201 - Armstrong (CD 11)",56,78,25,0,159
"Fairfax County",-,"202 - Flint Hill (CD 11)",86,65,28,0,179
"Fairfax County",-,"203 - Floris (CD 11)",101,86,26,0,213
"Fairfax County",-,"204 - Madison (CD 11)",4,18,2,0,24
"Fairfax County",-,"208 - Reston #1 (CD 11)",42,54,25,0,121
"Fairfax County",-,"209 - Reston #2 (CD 11)",67,37,31,0,135
"Fairfax County",-,"213 - Vienna #1 (CD 11)",73,53,15,0,141
"Fairfax County",-,"214 - Vienna #2 (CD 11)",57,44,24,0,125
"Fairfax County",-,"216 - Vienna #4 (CD 11)",34,17,12,0,63
"Fairfax County",-,"218 - Vienna #6 (CD 11)",34,30,9,0,73
"Fairfax County",-,"219 - Westbriar (CD 11)",85,52,29,0,166
"Fairfax County",-,"220 - Dogwood (CD 11)",62,71,18,0,151
"Fairfax County",-,"221 - Hunters Woods (CD 11)",80,51,24,0,155
"Fairfax County",-,"222 - Reston #3 (CD 11)",24,35,11,0,70
"Fairfax County",-,"223 - Glade (CD 11)",60,56,11,0,127
"Fairfax County",-,"224 - South Lakes (CD 11)",72,64,34,0,170
"Fairfax County",-,"225 - Hughes (CD 11)",41,48,19,0,108
"Fairfax County",-,"226 - Wolftrap (CD 11)",65,83,28,0,176
"Fairfax County",-,"227 - Sunrise Valley (CD 11)",52,45,11,0,108
"Fairfax County",-,"229 - Fox Mill (CD 10)",233,151,37,0,421
"Fairfax County",-,"233 - North Point (CD 11)",86,60,27,0,173
"Fairfax County",-,"234 - Aldrin (CD 11)",71,61,28,0,160
"Fairfax County",-,"235 - Frying Pan (CD 11)",50,61,13,0,124
"Fairfax County",-,"236 - Stuart (CD 11)",33,28,8,0,69
"Fairfax County",-,"237 - Mcnair (CD 11)",32,38,10,0,80
"Fairfax County",-,"238 - Cameron Glen (CD 11)",53,55,21,0,129
"Fairfax County",-,"240 - Colvin (CD 10)",106,102,27,0,235
"Fairfax County",-,"301 - Chain Bridge (CD 10)",154,93,34,0,281
"Fairfax County",-,"302 - Chesterbrook (CD 8)",81,88,21,0,190
"Fairfax County",-,"303 - Churchill (CD 10)",67,48,4,0,119
"Fairfax County",-,"304 - Cooper (CD 10)",73,100,9,0,182
"Fairfax County",-,"305 - El Nido (CD 8)",27,52,20,0,99
"Fairfax County",-,"306 - Great Falls (CD 10)",126,94,30,0,250
"Fairfax County",-,"307 - Haycock (CD 8)",60,48,28,0,136
"Fairfax County",-,"309 - Kenmore (CD 10)",188,115,34,0,337
"Fairfax County",-,"310 - Kirby (CD 8)",47,44,13,0,104
"Fairfax County",-,"311 - Langley (CD 10)",104,103,18,0,225
"Fairfax County",-,"312 - Longfellow (CD 8)",53,52,12,0,117
"Fairfax County",-,"314 - Mclean (CD 10)",98,71,16,0,185
"Fairfax County",-,"315 - Pimmit (CD 8)",55,53,16,0,124
"Fairfax County",-,"316 - Salona #1 (CD 8)",24,34,7,0,65
"Fairfax County",-,"317 - Westhampton (CD 8)",50,43,11,0,104
"Fairfax County",-,"318 - Westmoreland (CD 8)",38,38,17,0,93
"Fairfax County",-,"319 - Herndon #1 (CD 11)",102,78,31,0,211
"Fairfax County",-,"320 - Herndon #2 (CD 11)",91,79,24,0,194
"Fairfax County",-,"321 - Clearview (CD 10)",138,127,34,0,299
"Fairfax County",-,"322 - Forestville (CD 10)",196,144,27,0,367
"Fairfax County",-,"323 - Shouse (CD 10)",97,71,24,0,192
"Fairfax County",-,"324 - Herndon #3 (CD 11)",65,51,24,0,140
"Fairfax County",-,"325 - Hutchison (CD 11)",15,24,20,0,59
"Fairfax County",-,"327 - Sugarland (CD 10)",107,130,23,0,260
"Fairfax County",-,"328 - Hickory (CD 10)",160,119,34,0,313
"Fairfax County",-,"329 - Seneca (CD 10)",209,121,22,0,352
"Fairfax County",-,"331 - Spring Hill (CD 10)",125,110,23,0,258
"Fairfax County",-,"332 - Coates (CD 11)",35,26,22,0,83
"Fairfax County",-,"333 - Salona #2 (CD 8)",68,51,8,0,127
"Fairfax County",-,"401 - Bush Hill (CD 8)",57,108,22,0,187
"Fairfax County",-,"402 - Cameron (CD 8)",20,14,10,0,44
"Fairfax County",-,"403 - Forestdale (CD 8)",19,18,12,0,49
"Fairfax County",-,"404 - Franconia (CD 8)",46,46,14,0,106
"Fairfax County",-,"405 - Groveton (CD 8)",23,25,10,0,58
"Fairfax County",-,"406 - Hayfield (CD 8)",96,49,12,0,157
"Fairfax County",-,"408 - Mount Eagle (CD 8)",39,34,14,0,87
"Fairfax County",-,"409 - Pioneer (CD 8)",69,25,13,0,107
"Fairfax County",-,"410 - Rose Hill (CD 8)",69,80,21,0,170
"Fairfax County",-,"411 - Virginia Hills (CD 8)",44,47,13,0,104
"Fairfax County",-,"413 - Fairfield (CD 8)",17,13,13,0,43
"Fairfax County",-,"415 - Crestwood (CD 8)",67,34,13,0,114
"Fairfax County",-,"417 - Garfield (CD 8)",64,56,23,0,143
"Fairfax County",-,"418 - Lynbrook (CD 8)",33,19,11,0,63
"Fairfax County",-,"419 - Lane (CD 8)",56,27,25,0,108
"Fairfax County",-,"420 - Villages (CD 8)",67,67,24,0,158
"Fairfax County",-,"421 - Kingstowne (CD 8)",42,35,33,0,110
"Fairfax County",-,"422 - Van Dorn (CD 8)",52,51,18,0,121
"Fairfax County",-,"423 - Clermont (CD 8)",60,52,26,0,138
"Fairfax County",-,"424 - Huntley (CD 8)",49,60,37,0,146
"Fairfax County",-,"426 - Greenspring (CD 11)",97,56,53,0,206
"Fairfax County",-,"427 - Island Creek (CD 8)",40,41,16,0,97
"Fairfax County",-,"428 - Pinewood (CD 8)",36,12,18,0,66
"Fairfax County",-,"429 - Hybla Valley (CD 8)",32,12,13,0,57
"Fairfax County",-,"501 - Baileys (CD 8)",46,25,23,0,94
"Fairfax County",-,"502 - Barcroft (CD 11)",36,20,12,0,68
"Fairfax County",-,"503 - Belvedere (CD 11)",33,19,10,0,62
"Fairfax County",-,"504 - Bristow (CD 11)",41,32,10,0,83
"Fairfax County",-,"505 - Glen Forest (CD 8)",41,36,11,0,88
"Fairfax County",-,"506 - Holmes #1 (CD 8)",5,6,6,0,17
"Fairfax County",-,"507 - Lincolnia (CD 8)",53,36,24,0,113
"Fairfax County",-,"508 - Masonville (CD 11)",54,33,12,0,99
"Fairfax County",-,"509 - Plaza (CD 8)",21,28,14,0,63
"Fairfax County",-,"510 - Parklawn (CD 8)",35,36,14,0,85
"Fairfax County",-,"511 - Ravenwood (CD 11)",57,56,19,0,132
"Fairfax County",-,"512 - Sleepy Hollow (CD 11)",26,34,18,0,78
"Fairfax County",-,"513 - Saint Albans (CD 11)",37,25,11,0,73
"Fairfax County",-,"513 - Saint Albans (CD 8)",25,9,7,0,41
"Fairfax County",-,"514 - Crossroads (CD 8)",12,13,4,0,29
"Fairfax County",-,"515 - Westlawn (CD 8)",24,21,6,0,51
"Fairfax County",-,"516 - Weyanoke (CD 8)",57,42,16,0,115
"Fairfax County",-,"517 - Willston (CD 8)",17,15,11,0,43
"Fairfax County",-,"518 - Columbia (CD 11)",49,31,14,0,94
"Fairfax County",-,"519 - Hummer (CD 11)",45,38,15,0,98
"Fairfax County",-,"520 - Skyline (CD 8)",51,36,21,0,108
"Fairfax County",-,"521 - Brook Hill (CD 8)",65,31,23,0,119
"Fairfax County",-,"522 - Camelot (CD 11)",37,37,9,0,83
"Fairfax County",-,"523 - Poe (CD 8)",40,49,15,0,104
"Fairfax County",-,"525 - Walnut Hill (CD 8)",58,47,30,0,135
"Fairfax County",-,"526 - Bren Mar (CD 8)",48,45,24,0,117
"Fairfax County",-,"527 - Edsall (CD 8)",33,48,7,0,88
"Fairfax County",-,"528 - Ridgelea (CD 11)",50,26,9,0,85
"Fairfax County",-,"530 - Holmes #2 (CD 11)",33,9,16,0,58
"Fairfax County",-,"601 - Belle Haven (CD 8)",50,27,24,0,101
"Fairfax County",-,"602 - Belleview (CD 8)",35,59,15,0,109
"Fairfax County",-,"604 - Bucknell (CD 8)",48,36,22,0,106
"Fairfax County",-,"605 - Fort Hunt (CD 8)",74,62,29,0,165
"Fairfax County",-,"606 - Hollin Hall (CD 8)",67,63,25,0,155
"Fairfax County",-,"607 - Huntington (CD 8)",62,88,31,0,181
"Fairfax County",-,"608 - Kirkside (CD 8)",23,28,14,0,65
"Fairfax County",-,"609 - Marlan (CD 8)",75,52,22,0,149
"Fairfax County",-,"610 - Sherwood (CD 8)",48,34,11,0,93
"Fairfax County",-,"611 - Stratford (CD 8)",80,65,25,0,170
"Fairfax County",-,"612 - Waynewood (CD 8)",39,30,8,0,77
"Fairfax County",-,"613 - Westgate (CD 8)",143,97,25,0,265
"Fairfax County",-,"614 - Riverside (CD 8)",81,58,17,0,156
"Fairfax County",-,"615 - Woodley (CD 8)",80,65,22,0,167
"Fairfax County",-,"616 - Gunston (CD 8)",89,32,40,0,161
"Fairfax County",-,"617 - Lorton (CD 8)",26,20,4,0,50
"Fairfax County",-,"618 - Newington (CD 11)",86,80,38,0,204
"Fairfax County",-,"619 - Belvoir (CD 8)",78,40,23,0,141
"Fairfax County",-,"621 - Grosvenor (CD 8)",25,53,17,0,95
"Fairfax County",-,"622 - Lorton Station (CD 8)",48,18,16,0,82
"Fairfax County",-,"623 - Alban (CD 8)",52,34,16,0,102
"Fairfax County",-,"626 - Saratoga (CD 8)",88,53,19,0,160
"Fairfax County",-,"627 - Woodlawn (CD 8)",54,40,24,0,118
"Fairfax County",-,"628 - Laurel Hill (CD 11)",55,30,18,0,103
"Fairfax County",-,"629 - South County (CD 11)",97,60,18,0,175
"Fairfax County",-,"630- Army (CD 8)",12,11,4,0,27
"Fairfax County",-,"701 - Blake (CD 11)",77,58,18,0,153
"Fairfax County",-,"703 - Fort Buffalo (CD 8)",15,23,7,0,45
"Fairfax County",-,"704 - Freedom Hill (CD 11)",55,34,17,0,106
"Fairfax County",-,"705 - Graham - Greenway (CD 8)",61,42,27,0,130
"Fairfax County",-,"707 - Mantua (CD 11)",57,59,18,0,134
"Fairfax County",-,"708 - Marshall (CD 8)",60,69,29,0,158
"Fairfax County",-,"709 - Mosby (CD 11)",65,31,13,0,109
"Fairfax County",-,"710 - Pine Spring (CD 8)",43,35,9,0,87
"Fairfax County",-,"711 - Price (CD 11)",51,43,24,0,118
"Fairfax County",-,"712 - Shreve (CD 8)",32,26,8,0,66
"Fairfax County",-,"713 - Timber Lane (CD 8)",43,38,22,0,103
"Fairfax County",-,"714 - Walker (CD 11)",56,51,17,0,124
"Fairfax County",-,"717 - Woodburn (CD 11)",58,33,23,0,114
"Fairfax County",-,"718 - Pine Ridge (CD 11)",63,37,8,0,108
"Fairfax County",-,"720 - Thoreau (CD 11)",70,63,30,0,163
"Fairfax County",-,"721 - Merrifield (CD 11)",16,33,15,0,64
"Fairfax County",-,"723 - Gallows East (CD 11)",22,16,12,0,50
"Fairfax County",-,"726 - Magarity (CD 8)",63,64,29,0,156
"Fairfax County",-,"727 - Oakton (CD 11)",71,36,24,0,131
"Fairfax County",-,"729 - Nottoway (CD 11)",61,58,22,0,141
"Fairfax County",-,"730 - Penderbrook (CD 11)",76,54,24,0,154
"Fairfax County",-,"731 - Tysons (CD 11)",36,40,19,0,95
"Fairfax County",-,"732 - Oak Marr (CD 11)",88,76,25,0,189
"Fairfax County",-,"733 - Kilmer (CD 11)",54,47,30,0,131
"Fairfax County",-,"734 - Hunters Branch (CD 11)",34,38,13,0,85
"Fairfax County",-,"735 - Rotonda (CD 11)",49,29,7,0,85
"Fairfax County",-,"801 - Burke (CD 11)",73,51,30,0,154
"Fairfax County",-,"802 - Cedar Lake (CD 11)",17,14,6,0,37
"Fairfax County",-,"803 - Clifton (CD 10)",307,130,57,0,494
"Fairfax County",-,"804 - Colchester (CD 10)",144,55,16,0,215
"Fairfax County",-,"805 - Fairfax Station (CD 10)",112,47,24,0,183
"Fairfax County",-,"806 - Sydenstricker (CD 11)",106,74,29,0,209
"Fairfax County",-,"807 - Hunt Valley (CD 11)",64,42,17,0,123
"Fairfax County",-,"811 - Pohick (CD 11)",50,24,20,0,94
"Fairfax County",-,"812 - Valley (CD 11)",91,60,28,0,179
"Fairfax County",-,"815 - Woodyard (CD 10)",209,81,17,0,307
"Fairfax County",-,"824 - Orange (CD 11)",132,81,30,0,243
"Fairfax County",-,"825 - Cherry Run (CD 11)",83,65,28,0,176
"Fairfax County",-,"827 - Irving (CD 11)",78,39,32,0,149
"Fairfax County",-,"833 - White Oaks (CD 11)",78,58,19,0,155
"Fairfax County",-,"838 - Sangster (CD 10)",125,52,22,0,199
"Fairfax County",-,"839 - Silverbrook (CD 10)",198,100,34,0,332
"Fairfax County",-,"840 - West Springfield (CD 11)",65,68,18,0,151
"Fairfax County",-,"841 - Popes Head (CD 10)",124,53,18,0,195
"Fairfax County",-,"842 - Parkway (CD 11)",72,40,34,0,146
"Fairfax County",-,"843 - Fair Lakes (CD 11)",49,71,13,0,133
"Fairfax County",-,"844 - Centerpointe (CD 11)",36,40,20,0,96
"Fairfax County",-,"845 - Fountainhead (CD 10)",252,102,51,0,405
"Fairfax County",-,"846 - Greenbriar East (CD 11)",60,64,27,0,151
"Fairfax County",-,"847 - Greenbriar West (CD 10)",66,108,14,0,188
"Fairfax County",-,"848 - Fair Oaks (CD 11)",44,39,9,0,92
"Fairfax County",-,"849 - Newgate (CD 10)",255,180,49,0,484
"Fairfax County",-,"850 - South Run (CD 10)",173,113,24,0,310
"Fairfax County",-,"851 - Willow Springs (CD 11)",75,54,20,0,149
"Fairfax County",-,"901 - Centre Ridge (CD 11)",43,52,13,0,108
"Fairfax County",-,"902 - Brookfield (CD 10)",121,60,22,0,203
"Fairfax County",-,"903 - Cub Run (CD 10)",167,83,28,0,278
"Fairfax County",-,"904 - Stonecroft (CD 10)",68,32,21,0,121
"Fairfax County",-,"905 - Franklin (CD 10)",44,27,9,0,80
"Fairfax County",-,"908 - Hidden Meadow (CD 10)",87,75,23,0,185
"Fairfax County",-,"909 - Oak Hill (CD 10)",83,63,16,0,162
"Fairfax County",-,"910 - London Towne (CD 11)",56,51,21,0,128
"Fairfax County",-,"911 - Navy (CD 10)",115,72,18,0,205
"Fairfax County",-,"913 - Rocky Run (CD 10)",151,109,27,0,287
"Fairfax County",-,"914 - Vale (CD 10)",104,69,11,0,184
"Fairfax County",-,"915 - Virginia Run (CD 10)",186,65,44,0,295
"Fairfax County",-,"916 - Waples Mill (CD 10)",208,120,47,0,375
"Fairfax County",-,"917 - Stone North (CD 10)",46,58,8,0,112
"Fairfax County",-,"918 - Centreville (CD 11)",67,51,26,0,144
"Fairfax County",-,"919 - Green Trails (CD 11)",73,54,30,0,157
"Fairfax County",-,"920 - Chantilly (CD 10)",91,43,13,0,147
"Fairfax County",-,"921 - Deer Park (CD 10)",200,90,32,0,322
"Fairfax County",-,"923 - Bull Run (CD 10)",182,64,22,0,268
"Fairfax County",-,"924 - Spindle (CD 11)",24,26,7,0,57
"Fairfax County",-,"925 - Old Mill (CD 10)",62,30,12,0,104
"Fairfax County",-,"926 - Powell (CD 11)",67,40,34,0,141
"Fairfax County",-,"927 - Armfield (CD 10)",56,17,15,0,88
"Fairfax County",-,"928 - Poplar Tree (CD 10)",122,71,26,0,219
"Fairfax County",-,"929 - Difficult Run (CD 10)",54,20,6,0,80
"Fairfax County",-,"930 - Lees Corner (CD 10)",100,43,22,0,165
"Fairfax County",-,"931 - Carson (CD 10)",59,51,8,0,118
"Fairfax County",-,"932 - Stone South (CD 10)",36,7,4,0,47
"Fairfax County",-,"933 - Compton (CD 11)",14,13,11,0,38
"Fairfax County",-,"Ab - Central Absentee Precinct (CD 10)",441,329,66,0,836
"Fairfax County",-,"Ab - Central Absentee Precinct (CD 11)",342,259,109,0,710
"Fairfax County",-,"Ab - Central Absentee Precinct (CD 8)",158,154,57,0,369
"Fairfax County",-,"Provisional (CD 10)",2,3,1,0,6
"Fairfax County",-,"Provisional (CD 11)",4,2,2,0,8
"Fairfax County",-,"Provisional (CD 8)",1,1,0,0,2
"Fairfax City",-,"1 - One",56,41,13,0,110
"Fairfax City",-,"2 - Two",74,74,39,0,187
"Fairfax City",-,"3 - Three",98,55,28,0,181
"Fairfax City",-,"4 - Four",67,49,25,0,141
"Fairfax City",-,"5 - Five",59,41,15,0,115
"Fairfax City",-,"6 - Six",65,51,25,0,141
"Fairfax City",-,"Ab - Central Absentee Precinct",20,26,14,1,61
"Fairfax City",-,Provisional,0,0,0,0,0
"Falls Church City",-,"1 - First Ward",26,59,13,0,98
"Falls Church City",-,"2 - Second Ward",29,45,16,0,90
"Falls Church City",-,"3 - Third Ward",37,52,21,0,110
"Falls Church City",-,"Ab - Central Absentee Precinct",3,13,3,0,19
"Falls Church City",-,Provisional,0,0,0,0,0
"Fauquier County",-,"101 - Kettle Run (CD 5)",55,65,12,0,132
"Fauquier County",-,"102 - Catlett (CD 1)",122,98,12,0,232
"Fauquier County",-,"103 - Casanova (CD 5)",54,58,8,0,120
"Fauquier County",-,"104 - Lois (CD 1)",85,45,11,0,141
"Fauquier County",-,"105 - Opal (CD 5)",41,54,7,0,102
"Fauquier County",-,"106 - Baldwin Ridge (CD 5)",49,72,15,0,136
"Fauquier County",-,"201 - Courthouse (CD 5)",79,124,19,0,222
"Fauquier County",-,"202 - Airlie (CD 5)",85,97,18,0,200
"Fauquier County",-,"203 - Warrenton (CD 5)",72,102,30,0,204
"Fauquier County",-,"301 - Morrisville (CD 1)",89,92,6,0,187
"Fauquier County",-,"302 - Remington (CD 5)",87,125,19,0,231
"Fauquier County",-,"303 - Bealeton (CD 1)",91,100,8,0,199
"Fauquier County",-,"401 - Marshall (CD 5)",89,109,29,0,227
"Fauquier County",-,"402 - Leeds (CD 5)",99,77,15,0,191
"Fauquier County",-,"403 - Waterloo (CD 5)",102,137,22,0,261
"Fauquier County",-,"404 - Springs Valley (CD 5)",47,65,11,0,123
"Fauquier County",-,"501 - The Plains (CD 5)",70,73,15,0,158
"Fauquier County",-,"502 - New Baltimore (CD 5)",97,88,18,0,203
"Fauquier County",-,"503 - Broad Run (CD 5)",96,103,20,0,219
"Fauquier County",-,"504 - Vint Hill (CD 5)",123,130,33,0,286
"Fauquier County",-,"Ab - Central Absentee Precinct (CD 1)",9,7,0,0,16
"Fauquier County",-,"Ab - Central Absentee Precinct (CD 5)",35,27,8,0,70
"Fauquier County",-,"Provisional (CD 1)",0,0,0,0,0
"Fauquier County",-,"Provisional (CD 5)",0,1,0,0,1
"Floyd County",-,"101 - Locust Grove",65,38,5,0,108
"Floyd County",-,"201 - Little River",68,36,2,0,106
"Floyd County",-,"301 - Courthouse",50,28,6,0,84
"Floyd County",-,"401 - Burks Fork",45,44,3,0,92
"Floyd County",-,"501 - Indian Valley",66,39,7,0,112
"Floyd County",-,"Ab - Central Absentee Precinct",14,11,5,0,30
"Floyd County",-,Provisional,1,0,0,0,1
"Fluvanna County",-,"101 - Palmyra",89,96,12,0,197
"Fluvanna County",-,"201 - Columbia",63,106,21,0,190
"Fluvanna County",-,"301 - Fork Union",71,110,25,0,206
"Fluvanna County",-,"401 - Cunningham",114,91,29,0,234
"Fluvanna County",-,"501 - Rivanna",116,184,32,0,332
"Fluvanna County",-,"Ab - Central Absentee Precinct",13,25,10,0,48
"Fluvanna County",-,Provisional,0,0,0,0,0
"Franklin County",-,"102 - Burnt Chimney",67,99,17,0,183
"Franklin County",-,"103 - Scruggs",180,286,17,0,483
"Franklin County",-,"201 - Glade Hill",69,43,5,0,117
"Franklin County",-,"202 - Penhook",77,73,14,0,164
"Franklin County",-,"203 - Hodgesville",4,1,0,0,5
"Franklin County",-,"204 - Dudley",53,50,7,0,110
"Franklin County",-,"301 - Snow Creek",38,11,6,0,55
"Franklin County",-,"302 - Fork Mountain",35,11,1,0,47
"Franklin County",-,"303 - Sontag",21,23,7,0,51
"Franklin County",-,"304 - Dickinson",23,0,6,0,29
"Franklin County",-,"401 - Henry",53,27,6,0,86
"Franklin County",-,"402 - Ferrum",24,16,8,0,48
"Franklin County",-,"403 - Endicott",38,15,3,0,56
"Franklin County",-,"501 - Waidsboro",19,16,3,0,38
"Franklin County",-,"502 - Callaway",44,37,3,0,84
"Franklin County",-,"503 - Bowmans",24,16,2,0,42
"Franklin County",-,"504 - Gogginsville",69,21,9,0,99
"Franklin County",-,"601 - Boones Mill",48,35,10,0,93
"Franklin County",-,"602 - Bonbrook",50,46,9,0,105
"Franklin County",-,"603 - Coopers Cove",48,37,5,0,90
"Franklin County",-,"701 - Rocky Mount East",59,24,4,0,87
"Franklin County",-,"702 - Rocky Mount West",41,27,6,0,74
"Franklin County",-,"703 - Rocky Mount South",30,14,7,0,51
"Franklin County",-,"Ab - Central Absentee Precinct",21,26,10,0,57
"Franklin County",-,Provisional,0,0,0,0,0
"Franklin City",-,"101 - Precinct 1-1",44,23,15,0,82
"Franklin City",-,"201 - Precinct 2-1",32,19,5,0,56
"Franklin City",-,"301 - Precinct 3-1",8,4,9,0,21
"Franklin City",-,"401 - Precinct 4-1",2,2,4,0,8
"Franklin City",-,"501 - Precinct 5-1",0,3,8,0,11
"Franklin City",-,"601 - Precinct 6-1",18,18,4,0,40
"Franklin City",-,"Ab - Central Absentee Precinct",6,4,1,0,11
"Franklin City",-,Provisional,0,0,0,0,0
"Frederick County",-,"101 - Russells",196,74,45,0,315
"Frederick County",-,"102 - Gore",182,55,34,0,271
"Frederick County",-,"103 - Kernstown",215,79,94,0,388
"Frederick County",-,"104 - Cedar Creek",110,41,17,0,168
"Frederick County",-,"201 - Gainesborough",157,43,32,0,232
"Frederick County",-,"202 - Albin",216,61,42,0,319
"Frederick County",-,"203 - Redland",209,91,57,0,357
"Frederick County",-,"204 - Nain",206,72,55,0,333
"Frederick County",-,"301 - Clear Brook",101,37,30,0,168
"Frederick County",-,"302 - Neff's Town",136,75,55,0,266
"Frederick County",-,"303 - White Hall",266,90,42,0,398
"Frederick County",-,"401 - Carpers Valley",205,63,32,0,300
"Frederick County",-,"402 - Shenandoah",93,25,26,0,144
"Frederick County",-,"403 - Parkin's Mill",140,43,47,0,230
"Frederick County",-,"404 - Armel",146,73,32,0,251
"Frederick County",-,"501 - Stephens City",218,69,27,0,314
"Frederick County",-,"502 - Newtown",179,87,39,0,305
"Frederick County",-,"503 - Canterburg",218,85,103,0,406
"Frederick County",-,"601 - Millbrook",99,43,34,0,176
"Frederick County",-,"602 - Ash Hollow",125,62,47,0,234
"Frederick County",-,"603 - Greenwood",244,109,56,0,409
"Frederick County",-,"Ab - Central Absentee Precinct",116,45,35,0,196
"Frederick County",-,Provisional,2,0,1,0,3
"Fredericksburg City",-,"101 - Precinct 1 - District One",70,63,16,0,149
"Fredericksburg City",-,"201 - Precinct 1 - District Two",67,68,7,0,142
"Fredericksburg City",-,"301 - Precinct 1 - District Three",61,79,14,0,154
"Fredericksburg City",-,"401 - Precinct 1 - District Four",19,25,4,0,48
"Fredericksburg City",-,"402 - Precinct 2 - District Four",9,15,3,0,27
"Fredericksburg City",-,"Ab - Central Absentee Precinct",7,12,7,0,26
"Fredericksburg City",-,Provisional,1,2,0,0,3
"Galax City",-,"1 - East",37,32,3,0,72
"Galax City",-,"2 - North",19,24,6,0,49
"Galax City",-,"3 - South",29,15,1,0,45
"Galax City",-,"Ab - Central Absentee Precinct",3,1,0,0,4
"Galax City",-,Provisional,0,0,0,0,0
"Giles County",-,"101 - Glen Lyn",8,1,0,0,9
"Giles County",-,"102 - Rich Creek",34,7,4,0,45
"Giles County",-,"103 - Narrows",53,39,7,0,99
"Giles County",-,"201 - Pearisburg",79,55,7,0,141
"Giles County",-,"202 - Staffordsville",14,8,1,0,23
"Giles County",-,"203 - White Gate",18,7,3,0,28
"Giles County",-,"301 - Eggleston",26,10,5,0,41
"Giles County",-,"302 - Pembroke",72,26,9,0,107
"Giles County",-,"303 - Newport",41,33,4,0,78
"Giles County",-,"Ab - Central Absentee Precinct",25,5,1,0,31
"Giles County",-,Provisional,0,0,0,0,0
"Gloucester County",-,"101 - Harcum",51,87,23,0,161
"Gloucester County",-,"102 - Salem",52,60,11,0,123
"Gloucester County",-,"103 - Peasley",33,32,8,0,73
"Gloucester County",-,"201 - Courthouse",46,98,18,0,162
"Gloucester County",-,"202 - Botetourt",69,109,12,0,190
"Gloucester County",-,"301 - White Marsh",72,88,20,0,180
"Gloucester County",-,"302 - Roanes",74,102,38,0,214
"Gloucester County",-,"401 - Hayes",84,74,28,0,186
"Gloucester County",-,"402 - Sarahs Creek",51,66,22,0,139
"Gloucester County",-,"501 - Achilles",125,144,27,0,296
"Gloucester County",-,"502 - Walker",60,99,39,0,198
"Gloucester County",-,"Ab - Central Absentee Precinct",20,26,4,0,50
"Gloucester County",-,Provisional,0,0,0,0,0
"Goochland County",-,"101 - Fife",24,115,5,0,144
"Goochland County",-,"102 - Hadensville",50,142,11,0,203
"Goochland County",-,"201 - Three Square",14,29,1,0,44
"Goochland County",-,"202 - Sandy Hook",75,158,11,0,244
"Goochland County",-,"301 - Goochland Court House 1",52,144,10,0,206
"Goochland County",-,"302 - Goochland Court House 2",20,48,3,0,71
"Goochland County",-,"401 - Shallow Well",37,156,4,0,197
"Goochland County",-,"402 - Centerville",87,272,15,0,374
"Goochland County",-,"501 - Manakin",75,275,7,0,357
"Goochland County",-,"502 - Blair Road",62,173,11,0,246
"Goochland County",-,"Ab - Central Absentee Precinct",13,48,8,0,69
"Goochland County",-,Provisional,0,0,0,0,0
"Grayson County",-,"101 - Bridle Creek",12,5,2,0,19
"Grayson County",-,"102 - Flatridge",3,8,2,0,13
"Grayson County",-,"103 - Grant",11,8,0,0,19
"Grayson County",-,"104 - Mouth Of Wilson",8,3,2,0,13
"Grayson County",-,"105 - Mount Rogers",9,2,0,0,11
"Grayson County",-,"106 - Rugby",6,13,0,0,19
"Grayson County",-,"107 - Troutdale",4,1,0,0,5
"Grayson County",-,"108 - Comers Rock",11,3,1,0,15
"Grayson County",-,"202 - Elk Creek",28,16,6,0,50
"Grayson County",-,"203 - Independence",58,30,4,0,92
"Grayson County",-,"301 - Baywood",42,15,1,0,58
"Grayson County",-,"302 - Fairview",43,12,0,0,55
"Grayson County",-,"401 - Fries",16,7,1,0,24
"Grayson County",-,"402 - Providence",29,15,2,0,46
"Grayson County",-,"403 - Oldtown",20,13,3,0,36
"Grayson County",-,"Ab - Central Absentee Precinct",5,7,1,0,13
"Grayson County",-,Provisional,0,0,0,0,0
"Greene County",-,"101 - Dyke",46,43,16,0,105
"Greene County",-,"102 - Swift Run",28,49,15,0,92
"Greene County",-,"201 - Ruckersville",64,79,33,0,176
"Greene County",-,"301 - Stanardsville",91,87,35,0,213
"Greene County",-,"401 - Midway",88,104,47,0,239
"Greene County",-,"Ab - Central Absentee Precinct",22,22,9,0,53
"Greene County",-,Provisional,0,0,0,0,0
"Greensville County",-,"101 - Precinct 1-a",26,10,12,0,48
"Greensville County",-,"102 - Precinct 1-b",11,6,1,0,18
"Greensville County",-,"103 - Precinct 1-c",6,4,2,0,12
"Greensville County",-,"201 - Precinct 2-a",21,9,16,0,46
"Greensville County",-,"202 - Precinct 2-b",40,11,3,0,54
"Greensville County",-,"302 - Precinct 3-a",34,21,14,0,69
"Greensville County",-,"401 - Precinct 4-a",10,10,2,0,22
"Greensville County",-,"402 - Precinct 4-b",12,10,5,0,27
"Greensville County",-,"403 - Precinct 4-c",11,8,3,0,22
"Greensville County",-,Provisional,0,0,0,0,0
"Halifax County",-,"101 - Childrey",39,17,2,0,58
"Halifax County",-,"102 - Liberty",22,1,5,0,28
"Halifax County",-,"103 - Republican Grove",34,21,3,0,58
"Halifax County",-,"201 - Clays Mill",36,15,2,0,53
"Halifax County",-,"202 - Crossroads",34,17,1,0,52
"Halifax County",-,"203 - Clover",27,10,4,0,41
"Halifax County",-,"302 - Meadville",7,4,7,0,18
"Halifax County",-,"304 - Vernon Hill",24,15,6,0,45
"Halifax County",-,"305 - Sinai",19,8,3,0,30
"Halifax County",-,"401 - Courthouse",36,22,4,0,62
"Halifax County",-,"403 - Center",36,33,5,0,74
"Halifax County",-,"502 - Dan River",46,45,8,0,99
"Halifax County",-,"503 - Scottsburg",38,12,2,0,52
"Halifax County",-,"601 - Black Walnut",18,10,0,0,28
"Halifax County",-,"603 - Mt Carmel",29,38,3,0,70
"Halifax County",-,"605 - Union",14,15,1,0,30
"Halifax County",-,"701 - Hyco",43,14,4,0,61
"Halifax County",-,"702 - Midway",47,18,3,0,68
"Halifax County",-,"703 - Virgilina",25,15,6,0,46
"Halifax County",-,"801 - South Boston",25,18,8,0,51
"Halifax County",-,"Ab - Central Absentee Precinct",18,16,4,0,38
"Halifax County",-,Provisional,0,0,0,0,0
"Hampton City",-,"101 - Aberdeen (CD 3)",34,22,37,0,93
"Hampton City",-,"102 - Bassette (CD 3)",38,13,42,0,93
"Hampton City",-,"103 - City Hall (CD 3)",10,14,6,0,30
"Hampton City",-,"104 - Cooper (CD 3)",25,20,29,0,74
"Hampton City",-,"105 - East Hampton (CD 3)",27,15,12,0,54
"Hampton City",-,"106 - Armstrong (CD 3)",52,44,26,0,122
"Hampton City",-,"107 - Lindsay (CD 3)",22,15,24,0,61
"Hampton City",-,"108 - Thomas (CD 3)",21,13,16,0,50
"Hampton City",-,"109 - Phenix (CD 3)",17,12,26,0,55
"Hampton City",-,"110 - Phoebus (CD 2)",20,12,13,0,45
"Hampton City",-,"111 - Hampton Library (CD 3)",28,29,17,1,75
"Hampton City",-,"112 - Smith (CD 3)",67,33,44,0,144
"Hampton City",-,"115 - Wythe (CD 3)",42,49,26,1,118
"Hampton City",-,"116 - Jones (CD 3)",27,14,25,0,66
"Hampton City",-,"117 - Kecoughtan (CD 3)",31,24,15,0,70
"Hampton City",-,"118 - Mallory (CD 3)",8,14,10,0,32
"Hampton City",-,"201 - Booker (CD 2)",86,89,42,0,217
"Hampton City",-,"202 - Bryan (CD 2)",73,68,21,0,162
"Hampton City",-,"203 - Burbank (CD 2)",47,52,17,0,116
"Hampton City",-,"204 - Forrest (CD 3)",44,22,21,0,87
"Hampton City",-,"205 - Asbury (CD 2)",169,134,54,0,357
"Hampton City",-,"208 - Kraft (CD 3)",70,72,56,2,200
"Hampton City",-,"209 - Langley (CD 2)",71,32,16,0,119
"Hampton City",-,"210 - Machen (CD 3)",31,32,35,0,98
"Hampton City",-,"212 - Bethel (CD 3)",52,51,38,0,141
"Hampton City",-,"213 - Phillips (CD 2)",135,113,37,0,285
"Hampton City",-,"214 - Tucker Capps (CD 3)",68,61,34,0,163
"Hampton City",-,"215 - Tyler (CD 2)",1,0,1,0,2
"Hampton City",-,"215 - Tyler (CD 3)",6,5,10,0,21
"Hampton City",-,"216 - Sandy Bottom (CD 3)",43,31,37,0,111
"Hampton City",-,"217 - Syms (CD 3)",47,25,22,13,107
"Hampton City",-,"Ab - Central Absentee Precinct (CD 2)",27,10,4,0,41
"Hampton City",-,"Ab - Central Absentee Precinct (CD 3)",16,8,13,0,37
"Hampton City",-,"Provisional (CD 2)",0,1,0,0,1
"Hampton City",-,"Provisional (CD 3)",0,0,0,0,0
"Hanover County",-,"101 - Ashland",41,72,7,1,121
"Hanover County",-,"104 - Sliding Hill",71,79,11,0,161
"Hanover County",-,"105 - Berkley",32,43,7,0,82
"Hanover County",-,"106 - Kersey Creek",37,86,11,0,134
"Hanover County",-,"107 - Chickahominy",39,87,9,0,135
"Hanover County",-,"201 - Beaverdam",133,155,15,0,303
"Hanover County",-,"202 - Blunts",40,87,10,0,137
"Hanover County",-,"203 - Wilmington Parish",83,125,15,3,226
"Hanover County",-,"206 - Courthouse",43,80,4,0,127
"Hanover County",-,"208 - Oak Knoll",94,77,12,0,183
"Hanover County",-,"209 - West Hanover",31,28,1,0,60
"Hanover County",-,"210 - Oak Hill",29,25,6,0,60
"Hanover County",-,"301 - Clay",128,134,22,0,284
"Hanover County",-,"303 - Shady Grove",137,145,17,0,299
"Hanover County",-,"304 - Atlee",170,191,43,0,404
"Hanover County",-,"305 - Cool Spring",58,124,12,0,194
"Hanover County",-,"401 - Battlefield",164,145,19,0,328
"Hanover County",-,"403 - Cold Harbor",163,123,24,1,311
"Hanover County",-,"404 - Black Creek",195,178,16,0,389
"Hanover County",-,"405 - Pebble Creek",86,61,15,0,162
"Hanover County",-,"406 - Beaverdam Creek",31,29,3,0,63
"Hanover County",-,"502 - Rural Point",100,111,19,1,231
"Hanover County",-,"503 - Newman",78,58,13,2,151
"Hanover County",-,"504 - Studley",125,89,10,0,224
"Hanover County",-,"505 - Totopotomoy",100,68,7,0,175
"Hanover County",-,"506 - Georgetown",78,119,16,0,213
"Hanover County",-,"507 - Laurel Meadow",113,83,25,1,222
"Hanover County",-,"601 - Village",233,169,27,0,429
"Hanover County",-,"602 - Lee Davis",145,155,16,1,317
"Hanover County",-,"603 - Mechanicsville",78,45,8,0,131
"Hanover County",-,"604 - Hanover Grove",93,86,13,0,192
"Hanover County",-,"701 - Farrington",104,118,24,0,246
"Hanover County",-,"702 - Montpelier",87,99,16,0,202
"Hanover County",-,"703 - Rockville",98,136,11,0,245
"Hanover County",-,"704 - Elmont",85,119,26,0,230
"Hanover County",-,"705 - South Anna",44,75,12,0,131
"Hanover County",-,"Ab - Central Absentee Precinct",75,67,21,0,163
"Hanover County",-,Provisional,1,3,0,0,4
"Harrisonburg City",-,"101 - Northeast",47,34,11,0,92
"Harrisonburg City",-,"102 - East Central",21,33,3,0,57
"Harrisonburg City",-,"103 - Southeast",39,21,10,0,70
"Harrisonburg City",-,"104 - East",36,38,11,0,85
"Harrisonburg City",-,"105 - South East Central",4,4,0,0,8
"Harrisonburg City",-,"201 - Northwest",59,25,12,0,96
"Harrisonburg City",-,"202 - Southwest",55,30,12,0,97
"Harrisonburg City",-,"203 - West",46,49,15,0,110
"Harrisonburg City",-,"Ab - Central Absentee Precinct",19,16,10,0,45
"Harrisonburg City",-,Provisional,0,0,0,0,0
"Henrico County",-,"101 - Coalpit (CD 7)",51,129,13,0,193
"Henrico County",-,"102 - Dumbarton (CD 7)",38,52,6,0,96
"Henrico County",-,"103 - Glen Allen (CD 7)",76,188,18,0,282
"Henrico County",-,"105 - Greendale (CD 7)",59,67,11,2,139
"Henrico County",-,"106 - Hermitage (CD 7)",57,83,11,0,151
"Henrico County",-,"108 - Hungary Creek (CD 7)",104,195,17,2,318
"Henrico County",-,"109 - Hunton (CD 7)",34,65,9,1,109
"Henrico County",-,"110 - Johnson (CD 7)",38,62,3,2,105
"Henrico County",-,"111 - Lakeside (CD 7)",115,100,15,0,230
"Henrico County",-,"112 - Longan (CD 7)",72,117,8,0,197
"Henrico County",-,"113 - Maude Trevvett (CD 7)",31,55,15,1,102
"Henrico County",-,"114 - Monument Hills (CD 7)",38,47,7,0,92
"Henrico County",-,"115 - Staples Mill (CD 7)",104,192,12,0,308
"Henrico County",-,"117 - Westwood (CD 7)",46,75,5,0,126
"Henrico County",-,"201 - Adams (CD 4)",8,8,5,0,21
"Henrico County",-,"202 - Azalea (CD 7)",9,3,6,0,18
"Henrico County",-,"203 - Belmont (CD 7)",39,34,8,0,81
"Henrico County",-,"204 - Brookland (CD 7)",22,11,1,0,34
"Henrico County",-,"205 - Canterbury (CD 7)",58,87,7,1,153
"Henrico County",-,"206 - Central Gardens (CD 4)",7,14,9,0,30
"Henrico County",-,"207 - Chamberlayne (CD 7)",38,52,10,0,100
"Henrico County",-,"208 - Fairfield (CD 4)",12,6,13,0,31
"Henrico County",-,"209 - Glen Lea (CD 4)",24,16,10,0,50
"Henrico County",-,"210 - Greenwood (CD 7)",13,20,4,0,37
"Henrico County",-,"211 - Highland Gardens (CD 4)",3,10,6,0,19
"Henrico County",-,"212 - Hollybrook (CD 7)",21,16,4,0,41
"Henrico County",-,"213 - Hungary (CD 7)",10,13,6,0,29
"Henrico County",-,"214 - Longdale (CD 7)",33,28,3,0,64
"Henrico County",-,"215 - Maplewood (CD 4)",18,7,17,0,42
"Henrico County",-,"216 - Moody (CD 7)",41,44,9,0,94
"Henrico County",-,"217 - Mountain (CD 7)",10,33,6,0,49
"Henrico County",-,"218 - Oakview (CD 7)",4,4,4,0,12
"Henrico County",-,"219 - Randolph (CD 7)",7,1,0,0,8
"Henrico County",-,"220 - Ratcliffe (CD 4)",17,12,5,0,34
"Henrico County",-,"221 - Stratford Hall (CD 7)",13,9,1,0,23
"Henrico County",-,"222 - Wilder (CD 7)",22,21,4,0,47
"Henrico County",-,"223 - Yellow Tavern (CD 7)",69,103,8,1,181
"Henrico County",-,"224 - Essex Village (CD 4)",0,0,1,0,1
"Henrico County",-,"301 - Causeway (CD 7)",30,72,6,0,108
"Henrico County",-,"302 - Cedarfield (CD 7)",97,198,18,0,313
"Henrico County",-,"303 - Innsbrook (CD 7)",68,85,10,0,163
"Henrico County",-,"304 - Jackson Davis (CD 7)",55,61,6,0,122
"Henrico County",-,"305 - Nuckols Farm (CD 7)",71,151,14,1,237
"Henrico County",-,"306 - Pocahontas (CD 7)",45,73,11,0,129
"Henrico County",-,"307 - Ridge (CD 7)",35,95,7,0,137
"Henrico County",-,"308 - Rivers Edge (CD 7)",59,144,3,1,207
"Henrico County",-,"309 - Sadler (CD 7)",46,101,6,1,154
"Henrico County",-,"310 - Shady Grove (CD 7)",92,132,11,1,236
"Henrico County",-,"311 - Short Pump (CD 7)",48,160,11,0,219
"Henrico County",-,"312 - Springfield (CD 7)",34,46,7,0,87
"Henrico County",-,"313 - Stoney Run (CD 7)",95,163,15,0,273
"Henrico County",-,"314 - Three Chopt (CD 7)",79,110,15,0,204
"Henrico County",-,"315 - Tucker (CD 7)",28,46,6,0,80
"Henrico County",-,"401 - Quioccasin (CD 7)",61,135,9,0,205
"Henrico County",-,"402 - Crestview (CD 7)",39,53,6,1,99
"Henrico County",-,"403 - Derbyshire (CD 7)",58,140,7,0,205
"Henrico County",-,"404 - Freeman (CD 7)",35,81,6,0,122
"Henrico County",-,"405 - Gayton (CD 7)",96,277,17,0,390
"Henrico County",-,"406 - Godwin (CD 7)",58,144,5,0,207
"Henrico County",-,"407 - Lakewood (CD 7)",64,128,7,0,199
"Henrico County",-,"408 - Lauderdale (CD 7)",65,95,12,0,172
"Henrico County",-,"409 - Maybeury (CD 7)",77,167,23,0,267
"Henrico County",-,"410 - Mooreland (CD 7)",26,155,5,0,186
"Henrico County",-,"411 - Pemberton (CD 7)",44,72,15,0,131
"Henrico County",-,"412 - Pinchbeck (CD 7)",82,144,12,1,239
"Henrico County",-,"413 - Ridgefield (CD 7)",73,177,7,3,260
"Henrico County",-,"414 - Rollingwood (CD 7)",30,86,5,0,121
"Henrico County",-,"415 - Skipwith (CD 7)",44,46,4,1,95
"Henrico County",-,"416 - Spottswood (CD 7)",28,60,5,0,93
"Henrico County",-,"417 - Tuckahoe (CD 7)",79,245,19,0,343
"Henrico County",-,"418 - Welborne (CD 7)",27,84,3,0,114
"Henrico County",-,"419 - West End (CD 7)",48,168,8,0,224
"Henrico County",-,"501 - Antioch (CD 4)",92,108,16,0,216
"Henrico County",-,"502 - Cedar Fork (CD 4)",14,21,5,0,40
"Henrico County",-,"503 - Chickahominy (CD 4)",80,96,20,0,196
"Henrico County",-,"504 - Donahoe (CD 4)",30,41,17,0,88
"Henrico County",-,"505 - Dorey (CD 4)",74,86,37,0,197
"Henrico County",-,"506 - Eanes (CD 4)",24,16,5,0,45
"Henrico County",-,"507 - Elko (CD 4)",46,52,8,0,106
"Henrico County",-,"508 - Highland Springs (CD 4)",26,28,16,0,70
"Henrico County",-,"509 - Laburnum (CD 4)",32,28,14,0,74
"Henrico County",-,"510 - Mehfoud (CD 4)",36,34,20,1,91
"Henrico County",-,"511 - Montrose (CD 4)",30,25,17,0,72
"Henrico County",-,"512 - Nine Mile (CD 4)",23,23,10,0,56
"Henrico County",-,"513 - Pleasants (CD 4)",26,25,43,0,94
"Henrico County",-,"514 - Rolfe (CD 4)",28,27,22,0,77
"Henrico County",-,"515 - Sandston (CD 4)",85,78,28,0,191
"Henrico County",-,"516 - Sullivans (CD 4)",38,52,17,0,107
"Henrico County",-,"517 - Town Hall (CD 4)",30,35,6,0,71
"Henrico County",-,"518 - Whitlocks (CD 4)",73,86,16,0,175
"Henrico County",-,"AB - Central Absentee Precinct (CD 4)",25,15,15,0,55
"Henrico County",-,"Ab - Central Absentee Precinct (CD 7)",90,140,33,0,263
"Henrico County",-,"Provisional (CD 4)",0,0,0,0,0
"Henrico County",-,"Provisional (CD 7)",1,0,1,0,2
"Henry County",-,"101 - Bassett Number Two (CD 9)",15,10,3,0,28
"Henry County",-,"102 - Gunville (CD 9)",23,21,5,0,49
"Henry County",-,"103 - Scott's Tanyard (CD 9)",76,36,6,0,118
"Henry County",-,"201 - Fieldale (CD 9)",20,9,0,0,29
"Henry County",-,"202 - Horsepasture #1 (CD 9)",31,30,1,0,62
"Henry County",-,"203 - Horsepasture #2 (CD 9)",11,9,0,0,20
"Henry County",-,"204 - Spencer (CD 9)",48,19,4,0,71
"Henry County",-,"302 - Axton (CD 5)",16,15,1,0,32
"Henry County",-,"303 - Irisburg (CD 5)",47,27,5,0,79
"Henry County",-,"304 - Mount Olivet (CD 5)",33,45,4,0,82
"Henry County",-,"304 - Mount Olivet (CD 9)",0,0,0,0,0
"Henry County",-,"305 - Mountain Valley (CD 5)",35,19,8,0,62
"Henry County",-,"401 - Collinsville Number 1 (CD 9)",28,14,12,0,54
"Henry County",-,"402 - Daniels Creek (CD 9)",42,11,1,0,54
"Henry County",-,"404 - Collinsville Number 2 (CD 9)",48,19,10,0,77
"Henry County",-,"405 - Mountain View (CD 5)",17,21,3,0,41
"Henry County",-,"501 - Bassett Number One (CD 9)",18,16,1,0,35
"Henry County",-,"502 - Figsboro (CD 9)",51,12,8,0,71
"Henry County",-,"503 - Stanleytown (CD 9)",62,20,2,0,84
"Henry County",-,"504 - Oak Level (CD 9)",16,9,2,0,27
"Henry County",-,"505 - Dyers Store (CD 5)",3,2,0,0,5
"Henry County",-,"505 - Dyers Store (CD 9)",25,11,1,0,37
"Henry County",-,"601 - Fontaine (CD 9)",51,19,7,0,77
"Henry County",-,"602 - Hillcrest (CD 9)",14,5,1,0,20
"Henry County",-,"603 - Ridgeway #1 (CD 5)",44,42,7,0,93
"Henry County",-,"604 - Ridgeway #2 (CD 9)",34,26,3,0,63
"Henry County",-,"Ab - Central Absentee Precinct (CD 5)",9,6,0,0,15
"Henry County",-,"Ab - Central Absentee Precinct (CD 9)",27,4,3,0,34
"Henry County",-,"Provisional (CD 5)",0,0,0,0,0
"Henry County",-,"Provisional (CD 9)",0,0,0,0,0
"Highland County",-,"1 - Monterey",35,9,3,0,47
"Highland County",-,"3 - Wilsons Mill",8,4,1,0,13
"Highland County",-,"5 - Blue Grass",19,10,2,0,31
"Highland County",-,"7 - Mill Gap",13,8,6,0,27
"Highland County",-,"8 - Mcdowell",14,7,0,0,21
"Highland County",-,"10 - Headwaters",11,6,0,0,17
"Highland County",-,Provisional,0,0,0,0,0
"Hopewell City",-,"101 - Ward One",37,39,6,0,82
"Hopewell City",-,"201 - Ward Two",5,7,6,0,18
"Hopewell City",-,"301 - Ward Three",86,129,16,0,231
"Hopewell City",-,"401 - Ward Four",89,86,22,0,197
"Hopewell City",-,"501 - Ward Five",71,51,10,0,132
"Hopewell City",-,"601 - Ward Six",7,5,3,0,15
"Hopewell City",-,"701 - Ward Seven",25,34,6,0,65
"Hopewell City",-,"Ab - Central Absentee Precinct",11,11,2,0,24
"Hopewell City",-,Provisional,0,0,0,0,0
"Isle of Wight County",-,"101 - Smithfield",102,90,25,0,217
"Isle of Wight County",-,"102 - Cypress Creek",91,100,35,0,226
"Isle of Wight County",-,"201 - Bartlett",102,90,34,0,226
"Isle of Wight County",-,"202 - Carrollton",108,69,35,0,212
"Isle of Wight County",-,"301 - Rushmere",33,42,12,0,87
"Isle of Wight County",-,"302 - Pons",24,28,19,0,71
"Isle of Wight County",-,"401 - Courthouse",28,35,9,0,72
"Isle of Wight County",-,"402 - Windsor",88,44,18,0,150
"Isle of Wight County",-,"403 - Longview",54,36,20,0,110
"Isle of Wight County",-,"501 - Walters",59,35,10,0,104
"Isle of Wight County",-,"502 - Camps Mill",11,6,1,0,18
"Isle of Wight County",-,"503 - Carrsville",28,14,4,0,46
"Isle of Wight County",-,"504 - Zuni",51,40,25,0,116
"Isle of Wight County",-,"505 - Raynor",21,13,7,0,41
"Isle of Wight County",-,"Ab - Central Absentee Precinct",27,21,6,0,54
"Isle of Wight County",-,Provisional,0,0,1,0,1
"James City County",-,"101 - Berkeley A (CD 1)",93,126,30,0,249
"James City County",-,"102 - Berkeley B (CD 1)",58,80,27,0,165
"James City County",-,"103 - Berkeley C (CD 1)",155,258,62,0,475
"James City County",-,"104- Berkeley D (CD 2)",42,31,12,0,85
"James City County",-,"201 - Jamestown A (CD 2)",30,31,18,0,79
"James City County",-,"202 - Jamestown B (CD 1)",56,87,18,0,161
"James City County",-,"202 - Jamestown B (CD 2)",0,0,0,0,0
"James City County",-,"203 - Jamestown C (CD 1)",76,129,27,0,232
"James City County",-,"204 - Jamestown D (CD 1)",135,208,70,0,413
"James City County",-,"301 - Powhatan A (CD 1)",126,190,46,0,362
"James City County",-,"302 - Powhatan B (CD 1)",21,29,7,0,57
"James City County",-,"303 - Powhatan C (CD 1)",39,80,5,0,124
"James City County",-,"304 - Powhatan D (CD 1)",54,117,18,0,189
"James City County",-,"401 - Stonehouse A (CD 1)",72,173,31,0,276
"James City County",-,"402 - Stonehouse B (CD 1)",155,270,50,0,475
"James City County",-,"403 - Stonehouse C (CD 1)",82,193,25,0,300
"James City County",-,"501 - Roberts A (CD 2)",38,23,5,0,66
"James City County",-,"502 - Roberts B (CD 2)",166,191,62,0,419
"James City County",-,"503 - Roberts C (CD 2)",11,16,6,0,33
"James City County",-,"504 - Roberts D (CD 1)",0,0,0,0,0
"James City County",-,"504 - Roberts D (CD 2)",149,160,43,0,352
"James City County",-,"Ab - Central Absentee Precinct (CD 1)",96,89,35,0,220
"James City County",-,"AB - Central Absentee Precinct (CD 2)",0,0,0,0,0
"James City County",-,"Provisional (CD 1)",1,1,0,0,2
"James City County",-,"Provisional (CD 2)",1,0,0,0,1
"King and Queen County",-,"101 - Owenton",23,18,2,0,43
"King and Queen County",-,"201 - Clarks",28,39,7,0,74
"King and Queen County",-,"301 - Shacklefords",25,36,2,0,63
"King and Queen County",-,"401 - Courthouse",22,27,3,0,52
"King and Queen County",-,"501 - Oldmill",27,36,6,0,69
"King and Queen County",-,"Ab - Central Absentee Precinct",2,4,6,0,12
"King and Queen County",-,Provisional,5,4,0,0,9
"King George County",-,"101 - Courthouse",84,108,8,0,200
"King George County",-,"102 - Passapatanzy",38,42,11,0,91
"King George County",-,"201 - Monroe",155,163,17,0,335
"King George County",-,"301 - Dahlgren",76,110,11,0,197
"King George County",-,"401 - Shiloh",116,112,28,0,256
"King George County",-,"Ab - Central Absentee Precinct",30,25,7,0,62
"King George County",-,Provisional,1,0,0,0,1
"King William County",-,"101 - West Point",42,80,15,0,137
"King William County",-,"201 - Sweet Hall",25,27,5,0,57
"King William County",-,"202 - Courthouse",45,37,13,0,95
"King William County",-,"301 - Aylett",94,69,7,0,170
"King William County",-,"401 - Manquin",93,70,11,0,174
"King William County",-,"501 - Mangohick",76,77,11,0,164
"King William County",-,"Ab - Central Absentee Precinct",11,5,2,0,18
"King William County",-,Provisional,0,0,0,0,0
"Lancaster County",-,"101 - Precinct 1-1",64,118,14,0,196
"Lancaster County",-,"201 - Precinct 2-1",29,55,7,0,91
"Lancaster County",-,"301 - Precinct 3-1",34,79,9,0,122
"Lancaster County",-,"302 - Precinct 3-2",25,57,4,0,86
"Lancaster County",-,"401 - Precinct 4-1",25,56,8,0,89
"Lancaster County",-,"501 - Precinct 5-1",47,137,18,0,202
"Lancaster County",-,"Ab - Central Absentee Precinct",16,32,4,0,52
"Lancaster County",-,Provisional,0,0,0,0,0
"Lee County",-,"101 - Elydale",12,6,1,0,19
"Lee County",-,"102 - Ewing",12,7,0,0,19
"Lee County",-,"103 - Rose Hill",21,7,1,0,29
"Lee County",-,"201 - Blackwater",6,0,0,0,6
"Lee County",-,"202 - Flatwoods",17,1,4,0,22
"Lee County",-,"203 - Jonesville",21,9,3,0,33
"Lee County",-,"301 - Ben Hur",30,6,1,0,37
"Lee County",-,"302 - Woodway",14,5,0,0,19
"Lee County",-,"401 - Stickleyville",8,6,0,0,14
"Lee County",-,"402 - Jasper",5,2,1,0,8
"Lee County",-,"403 - Seminary",9,3,2,0,14
"Lee County",-,"404 - Dryden",10,2,2,0,14
"Lee County",-,"501 - Saint Charles",9,1,1,0,11
"Lee County",-,"502 - Pennington",21,6,0,0,27
"Lee County",-,"503 - Robbins Chapel",2,3,1,0,6
"Lee County",-,"504 - Keokee",7,4,0,0,11
"Lee County",-,"Ab - Central Absentee Precinct",8,6,0,0,14
"Lee County",-,Provisional,0,1,0,0,1
"Lexington City",-,"1 - Lexington",65,43,13,0,121
"Lexington City",-,"Ab - Central Absentee Precinct",9,6,3,0,18
"Lexington City",-,Provisional,0,0,0,0,0
"Loudoun County",-,"107 - Little River",83,77,16,0,176
"Loudoun County",-,"108 - Mercer",70,54,18,0,142
"Loudoun County",-,"112 - Freedom",34,57,7,0,98
"Loudoun County",-,"114 - Dulles South",55,31,9,0,95
"Loudoun County",-,"117 - Carter",20,12,4,0,36
"Loudoun County",-,"118 - Moorefield",45,56,11,0,112
"Loudoun County",-,"119 - Arcola",135,62,18,0,215
"Loudoun County",-,"120 - Lunsford",71,61,10,0,142
"Loudoun County",-,"121 - Town Hall",65,40,9,0,114
"Loudoun County",-,"122 - Hutchison Farm",89,62,25,0,176
"Loudoun County",-,"123 - Cardinal Ridge",62,52,6,0,120
"Loudoun County",-,"124 - Liberty",64,48,11,0,123
"Loudoun County",-,"125 - Rock Ridge",40,33,8,0,81
"Loudoun County",-,"207 - River Bend",103,71,17,0,191
"Loudoun County",-,"208 - Algonkian",88,59,23,0,170
"Loudoun County",-,"209 - Potomac Falls",88,64,17,0,169
"Loudoun County",-,"210 - Cascades",94,70,11,0,175
"Loudoun County",-,"213 - Countryside",33,20,9,0,62
"Loudoun County",-,"214 - Sugarland North",175,149,25,0,349
"Loudoun County",-,"215 - Sugarland South",134,85,28,0,247
"Loudoun County",-,"216 - Lowes Island",112,103,22,0,237
"Loudoun County",-,"217 - South Bank",121,88,22,0,231
"Loudoun County",-,"218 - University Center",42,34,21,0,97
"Loudoun County",-,"219 - Galilee Church",64,68,12,0,144
"Loudoun County",-,"301 - Purcellville",134,87,24,0,245
"Loudoun County",-,"302 - Round Hill",152,153,31,0,336
"Loudoun County",-,"303 - Hillsboro",134,98,24,0,256
"Loudoun County",-,"305 - Philomont",88,39,12,0,139
"Loudoun County",-,"307 - Middleburg",63,44,12,0,119
"Loudoun County",-,"308 - St Louis",56,45,11,0,112
"Loudoun County",-,"309 - Aldie",54,48,7,0,109
"Loudoun County",-,"310 - Mountain View",115,104,27,0,246
"Loudoun County",-,"311 - Round Hill Elementary",107,133,28,0,268
"Loudoun County",-,"312 - Briar Woods",51,40,14,0,105
"Loudoun County",-,"313 - Pinebrook",102,65,22,0,189
"Loudoun County",-,"314 - Legacy",58,43,14,0,115
"Loudoun County",-,"315 - Firehouse",59,28,13,0,100
"Loudoun County",-,"316 - Creighton's Corner",55,61,7,0,123
"Loudoun County",-,"318 - Madison's Trust",98,71,25,0,194
"Loudoun County",-,"319 - John Champe",72,53,14,0,139
"Loudoun County",-,"320 - Stone Hill",25,35,7,0,67
"Loudoun County",-,"321 - Brambleton Middle",31,20,10,0,61
"Loudoun County",-,"401 - West Lovettsville",169,151,30,0,350
"Loudoun County",-,"402 - Waterford",167,104,27,0,298
"Loudoun County",-,"403 - Lucketts",136,110,32,0,278
"Loudoun County",-,"407 - Harper Park",67,44,12,0,123
"Loudoun County",-,"408 - Evergreen",88,81,21,0,190
"Loudoun County",-,"409 - Clarkes Gap",168,103,29,0,300
"Loudoun County",-,"411 - East Lovettsville",133,122,27,0,282
"Loudoun County",-,"413 - Tuscarora",6,7,1,0,14
"Loudoun County",-,"414 - Red Rock",49,41,10,0,100
"Loudoun County",-,"416 - Hamilton",179,170,32,0,381
"Loudoun County",-,"420 - River Creek",129,111,28,0,268
"Loudoun County",-,"421 - Between The Hills",16,18,7,0,41
"Loudoun County",-,"422 - Sycolin Creek",95,74,14,0,183
"Loudoun County",-,"501 - West Leesburg",107,107,11,0,225
"Loudoun County",-,"502 - East Leesburg",69,47,18,0,134
"Loudoun County",-,"503 - Dry Mill",66,41,19,0,126
"Loudoun County",-,"504 - Smarts Mill",87,92,25,0,204
"Loudoun County",-,"505 - Cool Spring",110,140,37,0,287
"Loudoun County",-,"506 - Brandon Park",57,39,5,0,101
"Loudoun County",-,"507 - Greenway",67,60,21,0,148
"Loudoun County",-,"508 - Balls Bluff",81,80,19,0,180
"Loudoun County",-,"509 - Tolbert",47,73,17,0,137
"Loudoun County",-,"510 - Heritage",64,62,11,0,137
"Loudoun County",-,"615 - Hillside",98,92,24,0,214
"Loudoun County",-,"616 - Eagle Ridge",86,95,13,0,194
"Loudoun County",-,"617 - Oak Grove",16,14,5,0,35
"Loudoun County",-,"619 - Ridgetop",19,13,2,0,34
"Loudoun County",-,"620 - Russell Branch",154,61,32,0,247
"Loudoun County",-,"621 - Dominion Trail",100,82,27,0,209
"Loudoun County",-,"622 - Farmwell Station",122,85,16,0,223
"Loudoun County",-,"623 - Weller",170,62,27,0,259
"Loudoun County",-,"625 - Mill Run",48,44,10,0,102
"Loudoun County",-,"626 - Ashby Ponds",164,59,30,0,253
"Loudoun County",-,"627 - Ashbrook",62,33,10,0,105
"Loudoun County",-,"628 - Moorefield Station",48,36,10,0,94
"Loudoun County",-,"629 - Discovery",30,12,2,0,44
"Loudoun County",-,"701 - Sully",95,54,16,0,165
"Loudoun County",-,"702 - Park View",81,53,14,0,148
"Loudoun County",-,"703 - Rolling Ridge",63,39,11,0,113
"Loudoun County",-,"705 - Forest Grove",124,63,21,0,208
"Loudoun County",-,"707 - Claude Moore Park",38,34,18,0,90
"Loudoun County",-,"708 - Seneca",110,71,16,0,197
"Loudoun County",-,"709 - Mirror Ridge",64,47,18,0,129
"Loudoun County",-,"710 - Sterling",68,50,17,0,135
"Loudoun County",-,"808 - Stone Bridge",107,83,20,0,210
"Loudoun County",-,"810 - Cedar Lane",68,41,21,0,130
"Loudoun County",-,"813 - Seldens Landing",46,43,6,0,95
"Loudoun County",-,"814 - Newton - Lee",118,97,25,0,240
"Loudoun County",-,"815 - Belmont Ridge",168,74,38,0,280
"Loudoun County",-,"817 - Sanders Corner",119,103,23,0,245
"Loudoun County",-,"818 - Broad Run",67,49,20,0,136
"Loudoun County",-,"819 - Heritage Church",97,58,16,0,171
"Loudoun County",-,"820 - Belmont Station",63,56,23,0,142
"Loudoun County",-,"822 - Riverside",38,62,7,0,107
"Loudoun County",-,"Ab - Central Absentee Precinct",319,192,82,0,593
"Loudoun County",-,Provisional,3,5,2,0,10
"Louisa County",-,"101 - Zion",87,79,22,0,188
"Louisa County",-,"102 - Mechanicsville",45,40,11,0,96
"Louisa County",-,"201 - Louisa #1",40,100,11,0,151
"Louisa County",-,"202 - Louisa #2",53,80,13,0,146
"Louisa County",-,"301 - Patrick Henry No 1",47,92,12,0,151
"Louisa County",-,"302 - Patrick Henry #2",11,28,6,0,45
"Louisa County",-,"401 - Mineral",64,142,12,0,218
"Louisa County",-,"402 - Yanceyville",10,31,8,0,49
"Louisa County",-,"501 - Fredericks Hall",13,48,7,0,68
"Louisa County",-,"502 - Cuckoo",40,68,14,0,122
"Louisa County",-,"503 - Elk Creek",16,99,6,0,121
"Louisa County",-,"601 - Bumpass",45,89,16,0,150
"Louisa County",-,"602 - Locust Creek",65,108,13,0,186
"Louisa County",-,"701 - Sheltons Mill",49,83,8,0,140
"Louisa County",-,"702 - South Anna",46,83,14,0,143
"Louisa County",-,"Ab - Central Absentee Precinct",22,32,8,0,62
"Louisa County",-,Provisional,0,0,0,0,0
"Lunenburg County",-,"101 - Plymouth",7,43,8,0,58
"Lunenburg County",-,"201 - Browns Store",9,46,7,0,62
"Lunenburg County",-,"301 - Rosebud",13,20,0,0,33
"Lunenburg County",-,"302 - Flat Rock",6,27,0,0,33
"Lunenburg County",-,"401 - Arrowhead Gun Club",11,11,1,0,23
"Lunenburg County",-,"402 - Pleasant Grove",15,18,4,0,37
"Lunenburg County",-,"501 - Reedy Creek",14,23,6,0,43
"Lunenburg County",-,"502 - Peoples Community Center",7,10,3,0,20
"Lunenburg County",-,"601 - Hounds Creek",9,27,3,0,39
"Lunenburg County",-,"701 - Meherrin Fire Department",10,12,1,0,23
"Lunenburg County",-,"702 - Victoria Public Library",13,27,2,0,42
"Lunenburg County",-,"Ab - Central Absentee Precinct",3,11,2,0,16
"Lunenburg County",-,Provisional,0,0,0,0,0
"Lynchburg City",-,"101 - First Ward First Precinct",71,99,18,0,188
"Lynchburg City",-,"102 - First Ward Second Precinct",104,115,16,0,235
"Lynchburg City",-,"103 - First Ward Third Precinct",94,78,15,0,187
"Lynchburg City",-,"104 - First Ward Fourth Precinct",16,32,0,0,48
"Lynchburg City",-,"105 - First Ward Fifth Precinct",43,58,13,0,114
"Lynchburg City",-,"201 - Second Ward First Precinct",23,21,10,0,54
"Lynchburg City",-,"202 - Second Ward Second Precinct",21,22,5,0,48
"Lynchburg City",-,"203 - Second Ward Third Precinct",16,4,0,0,20
"Lynchburg City",-,"204 - Second Ward Fourth Precinct",28,9,4,0,41
"Lynchburg City",-,"301 - Third Ward First Precinct",36,25,9,0,70
"Lynchburg City",-,"302 - Third Ward Second Precinct",3,7,1,0,11
"Lynchburg City",-,"303 - Third Ward Third Precinct",37,29,2,0,68
"Lynchburg City",-,"304 - Third Ward Fourth Precinct",31,50,11,0,92
"Lynchburg City",-,"305 - Third Ward Fifth Precinct",90,97,20,0,207
"Lynchburg City",-,"401 - Fourth Ward First Precinct",141,132,25,0,298
"Lynchburg City",-,"402 - Fourth Ward Second Precinct",65,49,12,0,126
"Lynchburg City",-,"403 - Fourth Ward Third Precinct",71,66,14,0,151
"Lynchburg City",-,"404 - Fourth Ward Fourth Precinct",83,104,11,0,198
"Lynchburg City",-,"Ab - Central Absentee Precinct",18,26,12,0,56
"Lynchburg City",-,Provisional,1,0,0,0,1
"Madison County",-,"1 - Oak Park",24,52,4,0,80
"Madison County",-,"2 - Radiant",25,76,5,0,106
"Madison County",-,"3 - Rochelle",26,43,11,0,80
"Madison County",-,"4 - Graves Mill",11,11,0,0,22
"Madison County",-,"5 - Madison",36,115,10,0,161
"Madison County",-,"6 - Wolftown",19,52,8,0,79
"Madison County",-,"7 - Brightwood",44,146,12,0,202
"Madison County",-,"8 - Criglersville",14,51,3,0,68
"Madison County",-,"9 - Etlan",6,53,6,0,65
"Madison County",-,"Ab - Central Absentee Precinct",11,37,5,0,53
"Madison County",-,Provisional,0,0,0,0,0
"Manassas City",-,"1 - Dean",110,60,18,0,188
"Manassas City",-,"2 - Weems",201,66,39,0,306
"Manassas City",-,"3 - Metz",177,81,25,0,283
"Manassas City",-,"4 - Haydon",152,88,34,0,274
"Manassas City",-,"5 - Baldwin",111,61,35,0,207
"Manassas City",-,"6 - Round",188,115,39,0,342
"Manassas City",-,"Ab - Central Absentee Precinct",94,48,19,0,161
"Manassas City",-,Provisional,0,2,0,0,2
"Manassas Park City",-,"1 - Precinct One",60,38,7,0,105
"Manassas Park City",-,"2 - Precinct Two",92,14,11,0,117
"Manassas Park City",-,"3 - Precinct Three",93,25,17,0,135
"Manassas Park City",-,"Ab - Central Absentee Precinct",20,9,8,0,37
"Manassas Park City",-,Provisional,0,0,0,0,0
"Martinsville City",-,"1 - Precinct #1",4,1,0,0,5
"Martinsville City",-,"2 - Precinct #2",25,26,5,0,56
"Martinsville City",-,"3 - Precinct #3",7,5,2,0,14
"Martinsville City",-,"4 - Precinct #4",28,6,13,0,47
"Martinsville City",-,"5 - Precinct #5",56,84,8,0,148
"Martinsville City",-,"6 - Precinct #6",0,0,0,0,0
"Martinsville City",-,"Ab - Central Absentee Precinct",15,11,0,0,26
"Martinsville City",-,Provisional,0,0,0,0,0
"Mathews County",-,"1 - Chesapeake",40,96,18,1,155
"Mathews County",-,"2 - Westville",58,136,22,0,216
"Mathews County",-,"3 - Piankatank",43,208,12,0,263
"Mathews County",-,"Ab - Central Absentee Precinct",3,42,6,0,51
"Mathews County",-,Provisional,0,1,0,0,1
"Mecklenburg County",-,"101 - Wrights Store",20,16,10,0,46
"Mecklenburg County",-,"102 - Pearsons Store",9,10,9,0,28
"Mecklenburg County",-,"103 - South Clarksville",23,13,4,0,40
"Mecklenburg County",-,"201 - Boydton",14,14,3,0,31
"Mecklenburg County",-,"202 - Bluestone Senior High School",9,3,2,0,14
"Mecklenburg County",-,"203 - Chase City Vfw Post",11,4,2,0,17
"Mecklenburg County",-,"301 - Bracey",37,24,7,0,68
"Mecklenburg County",-,"302 - Lacrosse",11,14,0,0,25
"Mecklenburg County",-,"401 - American Legion Hall",20,12,3,0,35
"Mecklenburg County",-,"402 - Park View Middle School",0,4,0,0,4
"Mecklenburg County",-,"501 - South Hill",45,37,7,0,89
"Mecklenburg County",-,"601 - Baskerville",16,10,11,0,37
"Mecklenburg County",-,"602 - Union Level",8,4,3,0,15
"Mecklenburg County",-,"603 - Smith Crossroads",9,10,2,0,21
"Mecklenburg County",-,"604 - Lake Gaston",17,10,1,0,28
"Mecklenburg County",-,"701 - Chase City",25,24,4,0,53
"Mecklenburg County",-,"702 - Sunshine",23,12,0,0,35
"Mecklenburg County",-,"801 - Finchley",5,7,2,0,14
"Mecklenburg County",-,"802 - Bluestone",39,21,7,0,67
"Mecklenburg County",-,"803 - Chase City Elementary School",17,15,5,0,37
"Mecklenburg County",-,"901 - Averett",8,5,1,0,14
"Mecklenburg County",-,"902 - Buffalo Springs",10,15,0,0,25
"Mecklenburg County",-,"903 - Clarksville",56,57,5,0,118
"Mecklenburg County",-,"Ab - Central Absentee Precinct",6,9,0,0,15
"Mecklenburg County",-,Provisional,0,0,0,0,0
"Middlesex County",-,"101 - Saluda",10,32,0,0,42
"Middlesex County",-,"102 - Urbanna",25,53,7,0,85
"Middlesex County",-,"201 - New Market",46,185,9,0,240
"Middlesex County",-,"302 - Church View",27,57,11,0,95
"Middlesex County",-,"401- Harmony Village",29,72,12,0,113
"Middlesex County",-,"501 - Wilton",34,109,8,0,151
"Middlesex County",-,"Ab - Central Absentee Precinct",8,18,2,0,28
"Middlesex County",-,Provisional,0,0,0,0,0
"Montgomery County",-,"101 - Precinct A-1",63,48,11,0,122
"Montgomery County",-,"102 - Precinct A-2",14,30,3,0,47
"Montgomery County",-,"103 - Precinct A-3",35,79,12,0,126
"Montgomery County",-,"201 - Precinct B-1",6,6,0,0,12
"Montgomery County",-,"202 - Precinct B-2",59,51,11,0,121
"Montgomery County",-,"203 - Precinct B-3",40,39,7,0,86
"Montgomery County",-,"204 - Precinct B-4",71,74,19,0,164
"Montgomery County",-,"301 - Precinct C-1",50,43,7,0,100
"Montgomery County",-,"302 - Precinct C-2",74,67,8,0,149
"Montgomery County",-,"303 - Precinct C-3",22,20,3,0,45
"Montgomery County",-,"304 - Precinct C-4",50,45,6,0,101
"Montgomery County",-,"401 - Precinct D-1",35,47,4,0,86
"Montgomery County",-,"402 - Precinct D-2",59,42,11,0,112
"Montgomery County",-,"403 - Precinct D-3",39,26,2,0,67
"Montgomery County",-,"404 - Precinct D-4",44,19,2,0,65
"Montgomery County",-,"405 - Precinct D-5",59,60,3,0,122
"Montgomery County",-,"501 - Precinct E-1",46,36,4,0,86
"Montgomery County",-,"502 - Precinct E-2",29,20,13,0,62
"Montgomery County",-,"503 - Precinct E-3",0,0,0,0,0
"Montgomery County",-,"601 - Precinct F-1",26,35,8,0,69
"Montgomery County",-,"602 - Precinct F-2",14,30,4,0,48
"Montgomery County",-,"603 - Precinct F-3",0,0,0,0,0
"Montgomery County",-,"701 - Precinct G-1",46,38,11,0,95
"Montgomery County",-,"702 - Precinct G-2",4,16,3,0,23
"Montgomery County",-,"Ab - Central Absentee Precinct",20,36,8,0,64
"Montgomery County",-,Provisional,0,0,0,0,0
"Nelson County",-,"101 - Rockfish",46,63,15,0,124
"Nelson County",-,"201 - Lovingston",32,43,4,0,79
"Nelson County",-,"202 - Schuyler",25,23,6,0,54
"Nelson County",-,"301 - Shipman",38,32,7,0,77
"Nelson County",-,"302 - Gladstone",7,4,2,0,13
"Nelson County",-,"401 - Roseland",59,54,13,0,126
"Nelson County",-,"402 - Montebello",7,6,8,0,21
"Nelson County",-,"501 - Faber",15,21,9,0,45
"Nelson County",-,"502 - Nellysford",72,56,19,0,147
"Nelson County",-,"Ab - Central Absentee Precinct",8,9,2,0,19
"Nelson County",-,Provisional,0,1,0,0,1
"New Kent County",-,"102 - Tunstall",27,43,3,0,73
"New Kent County",-,"103 - Southern Branch",96,141,14,0,251
"New Kent County",-,"201 - Quinton",68,182,11,0,261
"New Kent County",-,"202 - Kentwood",52,92,6,0,150
"New Kent County",-,"301 - Watkins",38,97,6,0,141
"New Kent County",-,"302 - Cumberland",50,89,9,0,148
"New Kent County",-,"401 - Providence Forge",59,155,15,0,229
"New Kent County",-,"403 - Mountcastle",38,37,6,0,81
"New Kent County",-,"501 - Eltham",25,72,9,0,106
"New Kent County",-,"502 - Chickahominy River",62,108,10,0,180
"New Kent County",-,"Ab - Central Absentee Precinct",19,22,2,0,43
"New Kent County",-,Provisional,1,0,0,0,1
"Newport News City",-,"101 - Denbigh (CD 3)",47,45,36,0,128
"Newport News City",-,"102 - Epes (CD 3)",24,25,23,0,72
"Newport News City",-,"103 - Jenkins (CD 3)",53,81,19,0,153
"Newport News City",-,"104 - Mcintosh (CD 3)",10,21,10,0,41
"Newport News City",-,"105 - Oyster Point (CD 3)",13,21,12,0,46
"Newport News City",-,"106 - Reservoir (CD 3)",63,41,44,0,148
"Newport News City",-,"107 - Richneck (CD 3)",60,51,39,0,150
"Newport News City",-,"108 - Lee Hall (CD 3)",39,33,36,0,108
"Newport News City",-,"109 - Windsor (CD 3)",33,38,21,1,93
"Newport News City",-,"110 - Greenwood (CD 3)",34,39,49,0,122
"Newport News City",-,"201 - Bland (CD 3)",6,9,0,0,15
"Newport News City",-,"202 - Boulevard (CD 3)",78,65,22,0,165
"Newport News City",-,"203 - Charles (CD 3)",96,104,56,0,256
"Newport News City",-,"204 - Wellesley (CD 3)",29,39,17,0,85
"Newport News City",-,"205 - Deep Creek (CD 3)",100,100,35,0,235
"Newport News City",-,"208 - Hidenwood (CD 3)",70,80,34,0,184
"Newport News City",-,"209 - Hilton (CD 3)",72,62,39,0,173
"Newport News City",-,"210 - Nelson (CD 3)",93,118,32,0,243
"Newport News City",-,"211 - Palmer (CD 3)",32,54,26,0,112
"Newport News City",-,"212 - Riverside (CD 3)",31,56,18,0,105
"Newport News City",-,"213 - Sanford (CD 3)",31,41,19,0,91
"Newport News City",-,"215 - Warwick (CD 3)",16,41,28,0,85
"Newport News City",-,"216 - Yates (CD 3)",41,66,20,0,127
"Newport News City",-,"217 - Riverview (CD 3)",79,87,39,0,205
"Newport News City",-,"218 - Kiln Creek (CD 3)",82,93,65,0,240
"Newport News City",-,"219 - Deer Park (CD 3)",31,36,21,0,88
"Newport News City",-,"302 - Briarfield (CD 3)",10,12,17,0,39
"Newport News City",-,"303 - Carver (CD 3)",2,5,4,0,11
"Newport News City",-,"304 - Chestnut (CD 3)",1,2,2,0,5
"Newport News City",-,"305 - Downtown (CD 3)",8,5,8,0,21
"Newport News City",-,"306 - Dunbar (CD 3)",1,0,0,0,1
"Newport News City",-,"307 - Huntington (CD 3)",1,1,2,0,4
"Newport News City",-,"308 - Jefferson (CD 3)",0,0,1,0,1
"Newport News City",-,"309 - Magruder (CD 3)",0,1,1,0,2
"Newport News City",-,"310 - Marshall (CD 3)",4,0,6,0,10
"Newport News City",-,"311 - Newmarket (CD 3)",21,18,18,0,57
"Newport News City",-,"312 - Newsome Park (CD 3)",0,0,0,0,0
"Newport News City",-,"313 - Reed (CD 3)",9,3,15,0,27
"Newport News City",-,"314 - River (CD 3)",32,26,14,0,72
"Newport News City",-,"315 - Sedgefield (CD 3)",26,42,14,0,82
"Newport News City",-,"316 - South Morrison (CD 3)",35,29,24,0,88
"Newport News City",-,"317 - Washington (CD 3)",1,0,1,0,2
"Newport News City",-,"318 - Wilson (CD 3)",10,7,7,0,24
"Newport News City",-,"319 - Saunders (CD 3)",88,85,41,0,214
"Newport News City",-,"320 - Watkins (CD 3)",123,102,45,0,270
"Newport News City",-,"Ab - Central Absentee Precinct (CD 3)",40,35,13,0,88
"Newport News City",-,"Provisional (CD 3)",0,0,0,0,0
"Norfolk City",-,"101 - Granby (CD 2)",0,2,0,0,2
"Norfolk City",-,"101 - Granby (CD 3)",41,46,23,0,110
"Norfolk City",-,"102 - Ocean View School (CD 2)",34,30,8,0,72
"Norfolk City",-,"103 - Northside (CD 2)",95,51,22,0,168
"Norfolk City",-,"104 - Titustown (CD 2)",0,4,6,0,10
"Norfolk City",-,"104 - Titustown (CD 3)",0,0,1,0,1
"Norfolk City",-,"106 - Second Presbyterian (CD 2)",45,52,23,0,120
"Norfolk City",-,"201 - Larchmont School (CD 3)",32,43,28,0,103
"Norfolk City",-,"203 - Ghent Square (CD 3)",30,42,16,0,88
"Norfolk City",-,"207 - Lambert's Point (CD 3)",6,8,5,0,19
"Norfolk City",-,"208 - Larchmont Library (CD 3)",33,50,23,0,106
"Norfolk City",-,"210 - Maury (CD 3)",31,42,23,0,96
"Norfolk City",-,"211 - Chrysler Museum (CD 3)",43,81,27,0,151
"Norfolk City",-,"212 - Park Place (CD 3)",2,4,5,0,11
"Norfolk City",-,"213 - Taylor Elementary School (CD 3)",23,42,19,0,84
"Norfolk City",-,"214 - Stuart (CD 3)",28,35,17,0,80
"Norfolk City",-,"215 - Suburban Park (CD 2)",79,40,26,0,145
"Norfolk City",-,"217 - Wesley (CD 2)",28,28,10,0,66
"Norfolk City",-,"218 - Willard (CD 3)",45,88,44,0,177
"Norfolk City",-,"301 - Ballentine (CD 3)",8,12,15,0,35
"Norfolk City",-,"302 - Tanners Creek (CD 3)",9,14,11,0,34
"Norfolk City",-,"303 - Broad Creek (CD 3)",4,5,2,0,11
"Norfolk City",-,"304 - Coleman Place School (CD 3)",9,5,5,0,19
"Norfolk City",-,"305 - Lafayette-winona (CD 3)",8,9,4,0,21
"Norfolk City",-,"306 - Lindenwood (CD 3)",5,14,5,0,24
"Norfolk City",-,"309 - Norview (CD 3)",18,26,17,0,61
"Norfolk City",-,"310 - Rosemont (CD 3)",6,4,11,0,21
"Norfolk City",-,"311 - Sherwood (CD 3)",46,37,30,1,114
"Norfolk City",-,"313 - Union Chapel (CD 3)",5,2,6,0,13
"Norfolk City",-,"402 - Berkley (CD 3)",2,2,0,0,4
"Norfolk City",-,"403 - Brambleton (CD 3)",0,0,0,0,0
"Norfolk City",-,"404 - Campostella (CD 3)",4,4,8,0,16
"Norfolk City",-,"405 - Chesterfield (CD 3)",7,3,2,0,12
"Norfolk City",-,"406 - Barron Black (CD 2)",41,31,11,0,83
"Norfolk City",-,"408 - Easton (CD 3)",45,50,29,0,124
"Norfolk City",-,"409 - Fairlawn (CD 3)",29,44,16,0,89
"Norfolk City",-,"411 - Ruffner Academy (CD 3)",1,0,0,0,1
"Norfolk City",-,"412 - Ingleside (CD 3)",7,2,12,0,21
"Norfolk City",-,"413 - Poplar Halls (CD 3)",30,17,31,0,78
"Norfolk City",-,"414 - Young Park (CD 3)",0,0,1,0,1
"Norfolk City",-,"415 - Lake Taylor High School (CD 3)",32,33,27,0,92
"Norfolk City",-,"501 - Bayview (CD 2)",66,73,20,0,159
"Norfolk City",-,"503 - East Ocean View (CD 2)",74,96,27,0,197
"Norfolk City",-,"504 - Larrymore (CD 2)",60,42,20,0,122
"Norfolk City",-,"505 - Little Creek (CD 2)",41,50,11,0,102
"Norfolk City",-,"506 - Ocean View Center (CD 2)",53,51,25,0,129
"Norfolk City",-,"507 - Pretlow (CD 2)",99,63,28,0,190
"Norfolk City",-,"509 - Tarrallton (CD 2)",90,103,24,0,217
"Norfolk City",-,"510 - Third Presbyterian (CD 2)",91,105,19,1,216
"Norfolk City",-,"511 - Crossroads (CD 2)",69,62,37,0,168
"Norfolk City",-,"512 - Azalea Gardens (CD 2)",44,45,25,0,114
"Norfolk City",-,"Ab - Central Absentee Precinct (CD 2)",22,22,6,0,50
"Norfolk City",-,"Ab - Central Absentee Precinct (CD 3)",10,25,6,0,41
"Norfolk City",-,"Provisional (CD 2)",0,0,0,0,0
"Norfolk City",-,"Provisional (CD 3)",0,0,0,0,0
"Northampton County",-,"101 - Precinct 1-1",71,69,22,0,162
"Northampton County",-,"201 - Precinct 2-1",17,28,8,0,53
"Northampton County",-,"301 - Precinct 3-1",28,22,14,0,64
"Northampton County",-,"401 - Precinct 4-1",47,78,10,0,135
"Northampton County",-,"501 - Precinct 5-1",86,44,9,0,139
"Northampton County",-,"Ab - Central Absentee Precinct",25,10,0,0,35
"Northampton County",-,Provisional,0,0,0,0,0
"Northumberland County",-,"101 - 1a",43,126,6,0,175
"Northumberland County",-,"201 - 2a",58,148,5,0,211
"Northumberland County",-,"301 - 3a",19,40,1,0,60
"Northumberland County",-,"302 - 3b",8,11,2,0,21
"Northumberland County",-,"401 - 4a",72,209,17,0,298
"Northumberland County",-,"501 - 5a",91,215,6,0,312
"Northumberland County",-,"Ab - Central Absentee Precinct",7,21,0,0,28
"Northumberland County",-,Provisional,0,0,0,0,0
"Norton City",-,"1 - East Ward",20,14,6,0,40
"Norton City",-,Provisional,0,0,0,0,0
"Nottoway County",-,"101 - Precinct 1-1",9,52,1,0,62
"Nottoway County",-,"102 - Precinct 1-2",2,45,3,0,50
"Nottoway County",-,"201 - Precinct 2-1",32,64,9,0,105
"Nottoway County",-,"202 - Precinct 2-2",13,50,1,0,64
"Nottoway County",-,"301 - Precinct 3-1",14,13,3,0,30
"Nottoway County",-,"302 - Precinct 3-2",9,42,0,0,51
"Nottoway County",-,"401 - Precinct 4-1",3,7,0,0,10
"Nottoway County",-,"402 - Precinct 4-2",14,60,4,0,78
"Nottoway County",-,"501 - Precinct 5-1",23,90,2,0,115
"Nottoway County",-,"Ab - Central Absentee Precinct",3,8,1,0,12
"Nottoway County",-,Provisional,0,0,0,0,0
"Orange County",-,"101 - One West",60,130,15,0,205
"Orange County",-,"102 - One East",48,114,16,0,178
"Orange County",-,"201 - Two West",41,127,4,0,172
"Orange County",-,"202 - Two East",55,117,5,0,177
"Orange County",-,"301 - Three West",37,110,9,0,156
"Orange County",-,"302 - Three East",13,83,7,0,103
"Orange County",-,"401 - Four West",70,143,9,0,222
"Orange County",-,"402 - Four East",55,121,6,0,182
"Orange County",-,"501 - Five South",69,157,13,0,239
"Orange County",-,"502 - Five North",107,225,11,0,343
"Orange County",-,"Ab - Central Absentee Precinct",16,29,8,0,53
"Orange County",-,Provisional,0,0,0,0,0
"Page County",-,"101 - West Luray",86,33,18,0,137
"Page County",-,"201 - East Luray",129,53,18,0,200
"Page County",-,"301 - Marksville",84,34,14,0,132
"Page County",-,"401 - Newport",66,18,9,0,93
"Page County",-,"501 - Shenandoah",111,34,8,0,153
"Page County",-,"Ab - Central Absentee Precinct",14,13,4,0,31
"Page County",-,Provisional,0,0,0,0,0
"Patrick County",-,"101 - Ararat",10,7,1,0,18
"Patrick County",-,"102 - Claudville",41,9,1,0,51
"Patrick County",-,"103 - Willis Gap",21,7,3,0,31
"Patrick County",-,"201 - Dry Pond",7,8,1,0,16
"Patrick County",-,"202 - Patrick Springs",38,14,3,0,55
"Patrick County",-,"203 - Russell Creek",23,6,3,0,32
"Patrick County",-,"301 - Critz/stella",29,13,5,0,47
"Patrick County",-,"302 - Liberty",31,13,2,0,46
"Patrick County",-,"401 - Meadows Of Dan",38,16,9,0,63
"Patrick County",-,"402 - Stuart Fairgrounds",45,17,3,0,65
"Patrick County",-,"501 - Stuart Community",16,6,0,0,22
"Patrick County",-,"502 - Elamsville",39,10,1,0,50
"Patrick County",-,"503 - Woolwine",37,18,4,0,59
"Patrick County",-,"Ab - Central Absentee Precinct",12,9,1,0,22
"Patrick County",-,Provisional,0,0,0,0,0
"Petersburg City",-,"101 - First Ward First Precinct",5,6,4,0,15
"Petersburg City",-,"201 - Second Ward First Precinct",11,9,19,0,39
"Petersburg City",-,"301 - Third Ward First Precinct",26,37,22,0,85
"Petersburg City",-,"401 - Fourth Ward First Precinct",27,22,21,0,70
"Petersburg City",-,"501 - Fifth Ward First Precinct",10,4,7,0,21
"Petersburg City",-,"601 - Sixth Ward First Precinct",1,4,2,0,7
"Petersburg City",-,"701 - Seventh Ward First Precinct",7,8,2,0,17
"Petersburg City",-,"Ab - Central Absentee Precinct",16,13,1,0,30
"Petersburg City",-,Provisional,0,0,0,0,0
"Pittsylvania County",-,"103 - Twin Springs",118,56,32,0,206
"Pittsylvania County",-,"105 - Chatham",49,29,15,0,93
"Pittsylvania County",-,"106 - Tunstall",44,16,12,0,72
"Pittsylvania County",-,"108 - West Blairs",24,21,14,0,59
"Pittsylvania County",-,"201 - Callands",49,28,7,0,84
"Pittsylvania County",-,"202- Bearskin",15,9,7,0,31
"Pittsylvania County",-,"204 - Sandy Level",40,31,4,1,76
"Pittsylvania County",-,"206 - Climax",49,23,2,0,74
"Pittsylvania County",-,"207 - Gretna",56,54,22,0,132
"Pittsylvania County",-,"301 - Central",14,17,8,0,39
"Pittsylvania County",-,"305 - Riceville",24,5,10,0,39
"Pittsylvania County",-,"307 - East Blairs",7,6,14,0,27
"Pittsylvania County",-,"308 - Mt Airy",17,12,7,0,36
"Pittsylvania County",-,"309 - East Gretna",8,12,2,0,22
"Pittsylvania County",-,"402 - Keeling",67,12,7,0,86
"Pittsylvania County",-,"404 - Kentuck",72,47,7,0,126
"Pittsylvania County",-,"405 - Ringgold",92,20,9,0,121
"Pittsylvania County",-,"501 - Hurt",71,28,6,0,105
"Pittsylvania County",-,"502 - Motley Sycamore",78,21,15,0,114
"Pittsylvania County",-,"503 - Renan",44,28,6,0,78
"Pittsylvania County",-,"603 - Stony Mill",47,25,4,0,76
"Pittsylvania County",-,"604 - Swansonville",28,11,9,0,48
"Pittsylvania County",-,"605 - Whitmell",36,19,9,0,64
"Pittsylvania County",-,"606 - Brosville",25,9,8,0,42
"Pittsylvania County",-,"607 - Dry Fork",24,10,7,0,41
"Pittsylvania County",-,"702 - Bachelors Hall",65,49,15,0,129
"Pittsylvania County",-,"703 - Ferry Road",15,9,5,0,29
"Pittsylvania County",-,"704 - Mt Hermon",91,42,32,0,165
"Pittsylvania County",-,"705 - Mt Cross",61,24,10,0,95
"Pittsylvania County",-,"Ab - Central Absentee Precinct",37,25,19,0,81
"Pittsylvania County",-,Provisional,1,1,1,0,3
"Poquoson City",-,"1 - Central",142,111,37,0,290
"Poquoson City",-,"2 - Eastern",129,117,46,0,292
"Poquoson City",-,"3 - Western",172,157,59,0,388
"Poquoson City",-,"Ab - Central Absentee Precinct",23,17,5,0,45
"Poquoson City",-,Provisional,0,0,0,0,0
"Portsmouth City",-,"1 - Emanuel A. M. E. Church",24,30,29,1,84
"Portsmouth City",-,"5 - Hampton Roads Community Health Center",10,2,6,0,18
"Portsmouth City",-,"7- Park View Elementary School",14,20,12,0,46
"Portsmouth City",-,"9 - Third Baptist Church",11,12,16,0,39
"Portsmouth City",-,"10 - Port Norfolk Recreation Center",19,26,9,0,54
"Portsmouth City",-,"11 - Mt. Hermon Village",4,0,4,0,8
"Portsmouth City",-,"13 - St. Mark Missionary Baptist Church",4,1,1,0,6
"Portsmouth City",-,"14 - Brighton Elementary School",8,3,13,0,24
"Portsmouth City",-,"16 - Cradock Middle School",23,23,15,0,61
"Portsmouth City",-,"17 - Victory Life Fellowship",25,14,9,0,48
"Portsmouth City",-,"19 - Fairview Heights Baptist Church",13,16,8,0,37
"Portsmouth City",-,"20 - Noble Street Baptist Church",15,14,18,0,47
"Portsmouth City",-,"21 - John F. Kennedy Community Center",2,1,3,0,6
"Portsmouth City",-,"22 - Forward Church",23,20,7,0,50
"Portsmouth City",-,"23 - Westhaven Baptist Church",31,27,12,0,70
"Portsmouth City",-,"24 - Willett Hall",14,17,14,0,45
"Portsmouth City",-,"25 - John Tyler Elementary School",34,34,17,0,85
"Portsmouth City",-,"26 - William E. Waters Middle School",1,3,4,0,8
"Portsmouth City",-,"27 - Cavalier Manor Recreation Center",3,3,8,0,14
"Portsmouth City",-,"28 - Lakeview Elementary School",13,8,30,0,51
"Portsmouth City",-,"29 - Saint Andrew's United Methodist Church",23,29,10,0,62
"Portsmouth City",-,"30 - The Rescue Church",38,36,18,0,92
"Portsmouth City",-,"31 - West Park Church Of Christ",30,23,21,0,74
"Portsmouth City",-,"32 - Hodges Manor Elementary School",27,27,25,0,79
"Portsmouth City",-,"33- Pinecrest Baptist Church",48,38,11,0,97
"Portsmouth City",-,"34- Churchland Branch Library",44,35,12,1,92
"Portsmouth City",-,"35 - Churchland Elementary School",56,44,22,0,122
"Portsmouth City",-,"36 - Scottish Rite Temple",66,67,38,0,171
"Portsmouth City",-,"37 - Churchland Middle School",30,46,28,0,104
"Portsmouth City",-,"38 - Grove Baptist Church",13,16,19,0,48
"Portsmouth City",-,"39 - Churchland Primary And Intermediate School",36,55,32,0,123
"Portsmouth City",-,"Ab - Central Absentee Precinct",20,12,15,0,47
"Portsmouth City",-,Provisional,0,0,0,0,0
"Powhatan County",-,"101 - Subletts",107,139,12,0,258
"Powhatan County",-,"102 - Manakin",61,145,4,0,210
"Powhatan County",-,"103 - Flat Rock",55,79,5,0,139
"Powhatan County",-,"201 - Powhatan Station",81,105,9,0,195
"Powhatan County",-,"202 - Graceland",117,94,15,0,226
"Powhatan County",-,"301 - Bethesda",64,88,19,0,171
"Powhatan County",-,"302 - Lee's Landing",58,85,9,0,152
"Powhatan County",-,"401 - Powhatan Courthouse",136,177,22,0,335
"Powhatan County",-,"402 - Mt Zion",48,50,11,0,109
"Powhatan County",-,"501 - Smith Cross Roads",47,56,8,0,111
"Powhatan County",-,"502 - Pineville",31,40,3,0,74
"Powhatan County",-,"503 - Tobaccoville",33,36,6,0,75
"Powhatan County",-,"Ab - Central Absentee Precinct",25,22,4,0,51
"Powhatan County",-,Provisional,0,0,0,0,0
"Prince Edward County",-,"101 - Farmville",23,50,7,0,80
"Prince Edward County",-,"201 - Lockett",44,53,16,0,113
"Prince Edward County",-,"301 - Leigh",8,37,7,0,52
"Prince Edward County",-,"302 - Mt Pleasant",16,9,9,0,34
"Prince Edward County",-,"401 - Hampden",14,33,12,0,59
"Prince Edward County",-,"501 - Darlington Hts",21,33,4,0,58
"Prince Edward County",-,"502 - Buffalo Hts",15,20,8,0,43
"Prince Edward County",-,"601 - Prospect",33,39,13,0,85
"Prince Edward County",-,"701 - West End",22,40,7,0,69
"Prince Edward County",-,"801 - Center",6,3,2,0,11
"Prince Edward County",-,"Ab - Central Absentee Precinct",6,12,7,0,25
"Prince Edward County",-,Provisional,0,0,0,0,0
"Prince George County",-,"101 - Richard Bland (CD 4)",40,51,10,0,101
"Prince George County",-,"102 - Templeton (CD 4)",134,143,24,0,301
"Prince George County",-,"103 - Union Branch (CD 4)",79,70,26,0,175
"Prince George County",-,"104 - Rives (CD 4)",38,31,12,0,81
"Prince George County",-,"105 - Harrison (CD 4)",24,31,3,0,58
"Prince George County",-,"201 - Bland (CD 4)",94,157,28,0,279
"Prince George County",-,"202 - Black Water (CD 4)",98,121,12,0,231
"Prince George County",-,"203 - Brandon (CD 4)",36,34,7,0,77
"Prince George County",-,"204 - Courts Bldg (CD 4)",85,90,19,0,194
"Prince George County",-,"205 - Jefferson Park (CD 4)",31,36,15,0,82
"Prince George County",-,"Ab - Central Absentee Precinct (CD 4)",23,33,7,0,63
"Prince George County",-,"Provisional (CD 4)",0,0,0,0,0
"Prince William County",-,"101 - Brentsville (CD 1)",137,122,21,0,280
"Prince William County",-,"102 - Cedar Point (CD 1)",84,171,21,0,276
"Prince William County",-,"103 - Glenkirk (CD 1)",80,63,10,0,153
"Prince William County",-,"104 - Nokesville (CD 1)",110,154,14,0,278
"Prince William County",-,"105 - Limestone (CD 1)",98,102,16,0,216
"Prince William County",-,"106 - Westgate (CD 1)",49,21,4,0,74
"Prince William County",-,"107 - Marsteller (CD 1)",122,113,22,0,257
"Prince William County",-,"108 - Victory (CD 1)",85,106,16,0,207
"Prince William County",-,"109 - Piney Branch (CD 1)",58,54,11,0,123
"Prince William County",-,"110 - Buckland Mills (CD 1)",31,21,3,0,55
"Prince William County",-,"110 - Buckland Mills (CD 10)",72,38,7,0,117
"Prince William County",-,"111 - Bristow Run (CD 1)",128,123,20,0,271
"Prince William County",-,"112 - Burke-nickens (CD 1)",3,2,0,0,5
"Prince William County",-,"112 - Burke-nickens (CD 10)",122,81,18,0,221
"Prince William County",-,"201 - Saunders (CD 11)",55,52,39,0,146
"Prince William County",-,"202 - Marshall (CD 1)",175,115,16,0,306
"Prince William County",-,"203 - Bennett (CD 1)",115,73,33,0,221
"Prince William County",-,"204 - Ellis (CD 1)",99,34,15,0,148
"Prince William County",-,"205 - Buckhall (CD 10)",222,91,15,0,328
"Prince William County",-,"206 - Coles (CD 1)",167,58,11,0,236
"Prince William County",-,"207 - Spriggs (CD 1)",72,75,14,0,161
"Prince William County",-,"208 - Hylton (CD 1)",144,60,11,0,215
"Prince William County",-,"209 - Independent Hill (CD 1)",129,83,13,0,225
"Prince William County",-,"210 - Penn (CD 1)",162,89,7,0,258
"Prince William County",-,"210 - Penn (CD 11)",7,3,1,0,11
"Prince William County",-,"211 - Signal Hill (CD 10)",191,63,11,0,265
"Prince William County",-,"212 - Yorkshire (CD 10)",132,33,19,0,184
"Prince William County",-,"213 - Saratoga (CD 1)",52,16,5,0,73
"Prince William County",-,"214 - Lucasville (CD 1)",111,54,19,0,184
"Prince William County",-,"215 - Rosa Parks (CD 11)",62,44,47,0,153
"Prince William County",-,"301 - Dumfries (CD 11)",58,24,12,0,94
"Prince William County",-,"302 - Potomac (CD 11)",36,36,24,0,96
"Prince William County",-,"303 - Graham Park (CD 11)",18,11,3,0,32
"Prince William County",-,"304 - Quantico (CD 1)",19,9,1,0,29
"Prince William County",-,"305 - Pattie (CD 1)",90,57,12,0,159
"Prince William County",-,"306 - Washington-reid (CD 1)",128,67,14,0,209
"Prince William County",-,"307 - Henderson (CD 1)",106,82,15,0,203
"Prince William County",-,"308 - Montclair (CD 1)",66,47,12,0,125
"Prince William County",-,"309 - Ashland (CD 1)",65,54,11,0,130
"Prince William County",-,"310 - Forest Park (CD 1)",60,31,6,0,97
"Prince William County",-,"311 - Swans Creek (CD 11)",82,67,102,0,251
"Prince William County",-,"312 - Triangle (CD 1)",10,3,2,0,15
"Prince William County",-,"312 - Triangle (CD 11)",60,31,18,0,109
"Prince William County",-,"313 - Cardinal (CD 1)",46,35,6,0,87
"Prince William County",-,"314 - Cabin Branch (CD 1)",42,57,5,0,104
"Prince William County",-,"401 - Evergreen (CD 10)",263,98,26,0,387
"Prince William County",-,"402 - Battlefield (CD 10)",230,108,36,0,374
"Prince William County",-,"403 - Bull Run (CD 10)",91,58,13,0,162
"Prince William County",-,"404 - Ben Lomond (CD 1)",47,28,5,0,80
"Prince William County",-,"405 - Stonewall (CD 1)",66,33,16,0,115
"Prince William County",-,"406 - Alvey (CD 10)",163,69,16,0,248
"Prince William County",-,"407 - Heritage Hunt (CD 10)",558,140,50,0,748
"Prince William County",-,"408 - Sudley (CD 1)",109,34,4,0,147
"Prince William County",-,"409 - Tyler (CD 10)",96,61,18,0,175
"Prince William County",-,"410 - Mountain View (CD 10)",188,60,34,0,282
"Prince William County",-,"411 - Mullen (CD 1)",23,18,2,0,43
"Prince William County",-,"412 - Catharpin (CD 10)",169,73,22,0,264
"Prince William County",-,"413 - Reagan (CD 10)",202,89,24,0,315
"Prince William County",-,"501 - Lake Ridge (CD 1)",75,41,9,0,125
"Prince William County",-,"502 - Occoquan (CD 11)",57,44,17,0,118
"Prince William County",-,"503 - Old Bridge (CD 11)",58,32,9,0,99
"Prince William County",-,"504 - Rockledge (CD 11)",103,66,10,0,179
"Prince William County",-,"505 - Mohican (CD 1)",114,62,16,0,192
"Prince William County",-,"506 - Bethel (CD 11)",125,72,16,0,213
"Prince William County",-,"507 - Chinn (CD 11)",84,52,22,0,158
"Prince William County",-,"508 - Springwoods (CD 1)",38,22,8,0,68
"Prince William County",-,"509 - Mc Coart (CD 1)",209,102,17,0,328
"Prince William County",-,"510 - Yates Ford (CD 10)",185,90,22,0,297
"Prince William County",-,"511 - Westridge (CD 1)",95,64,4,0,163
"Prince William County",-,"512 - York (CD 11)",30,27,18,0,75
"Prince William County",-,"513 - Lynnwood (CD 11)",125,98,27,0,250
"Prince William County",-,"514 - Antietam (CD 11)",101,94,31,0,226
"Prince William County",-,"601 - Dale (CD 11)",44,24,8,0,76
"Prince William County",-,"602 - Beville (CD 11)",67,63,24,0,154
"Prince William County",-,"603 - Hampton (CD 11)",29,16,8,0,53
"Prince William County",-,"604 - Gideon (CD 11)",61,30,31,0,122
"Prince William County",-,"605 - Minnieville (CD 11)",75,29,16,0,120
"Prince William County",-,"606 - Bel Air (CD 11)",86,41,17,0,144
"Prince William County",-,"607 - Kerrydale (CD 11)",66,37,22,0,125
"Prince William County",-,"608 - Enterprise (CD 11)",69,39,13,0,121
"Prince William County",-,"609 - King (CD 1)",0,0,0,0,0
"Prince William County",-,"609 - King (CD 11)",87,45,19,0,151
"Prince William County",-,"610 - Fitzgerald (CD 11)",67,55,25,0,147
"Prince William County",-,"611 - Neabsco (CD 11)",58,31,13,0,102
"Prince William County",-,"701 - Belmont (CD 11)",78,57,25,0,160
"Prince William County",-,"702 - Library (CD 11)",45,50,40,0,135
"Prince William County",-,"703 - Lynn (CD 11)",21,9,13,0,43
"Prince William County",-,"704 - Porter (CD 11)",26,21,19,0,66
"Prince William County",-,"705 - Potomac View (CD 11)",74,25,2,0,101
"Prince William County",-,"706 - Rippon (CD 11)",87,44,18,0,149
"Prince William County",-,"707 - Kilby (CD 11)",50,23,13,0,86
"Prince William County",-,"708 - River Oaks (CD 11)",29,29,56,0,114
"Prince William County",-,"709 - Freedom (CD 11)",26,24,7,0,57
"Prince William County",-,"710 - Powells Creek (CD 11)",15,11,9,0,35
"Prince William County",-,"711 - Grayson (CD 11)",63,23,11,0,97
"Prince William County",-,"712 - Leesylvania (CD 11)",89,66,28,0,183
"Prince William County",-,"Ab - Central Absentee Precinct (CD 1)",170,121,31,0,322
"Prince William County",-,"Ab - Central Absentee Precinct (CD 10)",208,67,23,0,298
"Prince William County",-,"Ab - Central Absentee Precinct (CD 11)",137,86,42,0,265
"Prince William County",-,"Provisional (CD 1)",1,1,0,0,2
"Prince William County",-,"Provisional (CD 10)",1,0,0,0,1
"Prince William County",-,"Provisional (CD 11)",0,0,0,0,0
"Pulaski County",-,"101 - Belspring",18,15,1,0,34
"Pulaski County",-,"102 - New River",45,19,4,0,68
"Pulaski County",-,"103 - West Cloyd",29,17,2,0,48
"Pulaski County",-,"201 - Draper",37,22,9,0,68
"Pulaski County",-,"202 - South Pulaski",6,3,0,0,9
"Pulaski County",-,"203 - Newbern",44,28,8,0,80
"Pulaski County",-,"301 - Dublin",47,39,8,0,94
"Pulaski County",-,"302 - Hiwassee",17,3,0,0,20
"Pulaski County",-,"304 - Snowville",30,17,6,0,53
"Pulaski County",-,"401 - Massie",52,33,5,0,90
"Pulaski County",-,"402 - Walker",20,16,0,0,36
"Pulaski County",-,"501 - Robinson",55,35,4,0,94
"Pulaski County",-,"Ab - Central Absentee Precinct",7,6,1,0,14
"Pulaski County",-,Provisional,0,0,0,0,0
"Radford City",-,"1 - East Precinct",32,40,8,0,80
"Radford City",-,"2 - Central Precinct",49,47,6,0,102
"Radford City",-,"3 - West Precinct",60,51,14,0,125
"Radford City",-,"Ab - Central Absentee Precinct",2,5,1,0,8
"Radford City",-,Provisional,0,0,0,0,0
"Rappahannock County",-,"101 - Washington",43,48,9,0,100
"Rappahannock County",-,"201 - Amissville",40,45,11,0,96
"Rappahannock County",-,"301 - Sperryville",33,39,6,0,78
"Rappahannock County",-,"401 - Scrabble",34,36,9,2,81
"Rappahannock County",-,"501 - Chester Gap",21,20,27,0,68
"Rappahannock County",-,"502 - Flint Hill",26,21,7,3,57
"Rappahannock County",-,"Ab - Central Absentee Precinct",2,18,4,0,24
"Rappahannock County",-,Provisional,0,0,0,0,0
"Richmond County",-,"101 - Precinct 1-1",12,17,2,0,31
"Richmond County",-,"201 - Precinct 2-1",11,17,2,0,30
"Richmond County",-,"301 - Precinct 3-1",14,34,4,0,52
"Richmond County",-,"401 - Precinct 4-1",17,49,3,0,69
"Richmond County",-,"501 - Precinct 5-1",23,52,7,0,82
"Richmond County",-,"Ab - Central Absentee Precinct",4,5,0,0,9
"Richmond County",-,Provisional,0,0,0,0,0
"Richmond City",-,"101 - One Hundred One (CD 4)",7,34,9,0,50
"Richmond City",-,"102 - One Hundred Two (CD 4)",23,70,12,0,105
"Richmond City",-,"104 - One Hundred Four (CD 4)",41,101,23,0,165
"Richmond City",-,"105 - One Hundred Five (CD 4)",22,80,19,0,121
"Richmond City",-,"106 - One Hundred Six (CD 4)",49,160,16,0,225
"Richmond City",-,"111 - One Hundred Eleven (CD 4)",38,51,16,0,105
"Richmond City",-,"112 - One Hundred Twelve (CD 4)",34,74,19,0,127
"Richmond City",-,"113 - One Hundred Thirteen (CD 4)",25,56,20,0,101
"Richmond City",-,"114 - One Hundred Fourteen (CD 4)",26,66,29,0,121
"Richmond City",-,"115 - One Hundred Fifteen (CD 4)",37,93,15,0,145
"Richmond City",-,"203 - Two Hundred Three (CD 4)",22,76,35,0,133
"Richmond City",-,"204 - Two Hundred Four (CD 4)",22,82,19,0,123
"Richmond City",-,"206 - Two Hundred Six (CD 4)",11,29,9,0,49
"Richmond City",-,"207 - Two Hundred Seven (CD 4)",25,84,26,0,135
"Richmond City",-,"208 - Two Hundred Eight (CD 4)",17,73,19,0,109
"Richmond City",-,"213 - Two Hundred Thirteen (CD 4)",8,30,24,0,62
"Richmond City",-,"214 - Two Hundred Fourteen (CD 4)",9,9,2,0,20
"Richmond City",-,"301 - Three Hundred One (CD 4)",6,9,8,0,23
"Richmond City",-,"302 - Three Hundred Two (CD 4)",10,19,14,0,43
"Richmond City",-,"303 - Three Hundred Three (CD 4)",9,13,6,0,28
"Richmond City",-,"304 - Three Hundred Four (CD 4)",1,5,11,0,17
"Richmond City",-,"305 - Three Hundred Five (CD 4)",6,8,8,0,22
"Richmond City",-,"306 - Three Hundred Six (CD 4)",9,15,11,0,35
"Richmond City",-,"307 - Three Hundred Seven (CD 4)",12,38,12,0,62
"Richmond City",-,"308 - Three Hundred Eight (CD 4)",20,48,18,0,86
"Richmond City",-,"309 - Three Hundred Nine (CD 4)",34,67,21,0,122
"Richmond City",-,"310 - Three Hundred Ten (CD 4)",1,1,0,0,2
"Richmond City",-,"402 - Four Hundred Two (CD 4)",63,101,14,0,178
"Richmond City",-,"404 - Four Hundred Four (CD 4)",31,57,12,0,100
"Richmond City",-,"409 - Four Hundred Nine (CD 4)",67,176,53,0,296
"Richmond City",-,"410 - Four Hundred Ten (CD 4)",45,60,23,0,128
"Richmond City",-,"412 - Four Hundred Twelve (CD 4)",20,39,30,0,89
"Richmond City",-,"413 - Four Hundred Thirteen (CD 4)",57,79,23,0,159
"Richmond City",-,"414 - Four Hundred Fourteen (CD 4)",43,96,25,0,164
"Richmond City",-,"501 - Five Hundred One (CD 4)",15,41,25,0,81
"Richmond City",-,"503 - Five Hundred Three (CD 4)",12,22,11,0,45
"Richmond City",-,"504 - Five Hundred Four (CD 4)",10,30,24,0,64
"Richmond City",-,"505 - Five Hundred Five (CD 4)",6,11,7,0,24
"Richmond City",-,"508 - Five Hundred Eight (CD 4)",12,43,12,0,67
"Richmond City",-,"509 - Five Hundred Nine (CD 4)",9,16,6,0,31
"Richmond City",-,"510 - Five Hundred Ten (CD 4)",8,19,19,0,46
"Richmond City",-,"602 - Six Hundred Two (CD 4)",0,1,6,0,7
"Richmond City",-,"603 - Six Hundred Three (CD 4)",4,6,8,0,18
"Richmond City",-,"604 - Six Hundred Four (CD 4)",7,5,3,0,15
"Richmond City",-,"606 - Six Hundred Six (CD 4)",5,9,7,0,21
"Richmond City",-,"607 - Six Hundred Seven (CD 4)",10,30,14,0,54
"Richmond City",-,"609 - Six Hundred Nine (CD 4)",20,26,24,0,70
"Richmond City",-,"610 - Six Hundred Ten (CD 4)",5,4,6,0,15
"Richmond City",-,"701 - Seven Hundred One (CD 4)",4,1,3,0,8
"Richmond City",-,"702 - Seven Hundred Two (CD 4)",1,6,1,0,8
"Richmond City",-,"703 - Seven Hundred Three (CD 4)",9,10,10,0,29
"Richmond City",-,"705 - Seven Hundred Five (CD 4)",9,22,15,0,46
"Richmond City",-,"706 - Seven Hundred Six (CD 4)",11,19,11,0,41
"Richmond City",-,"707 - Seven Hundred Seven (CD 4)",27,53,16,0,96
"Richmond City",-,"708 - Seven Hundred Eight (CD 4)",12,30,9,0,51
"Richmond City",-,"802 - Eight Hundred Two (CD 4)",8,3,2,0,13
"Richmond City",-,"806 - Eight Hundred Six (CD 4)",7,9,5,0,21
"Richmond City",-,"810 - Eight Hundred Ten (CD 4)",12,13,26,0,51
"Richmond City",-,"811 - Eight Hundred Eleven (CD 4)",6,5,4,0,15
"Richmond City",-,"812 - Eight Hundred Twelve (CD 4)",17,22,18,0,57
"Richmond City",-,"814 - Eight Hundred Fourteen (CD 4)",3,3,2,0,8
"Richmond City",-,"902 - Nine Hundred Two (CD 4)",4,3,5,0,12
"Richmond City",-,"903 - Nine Hundred Three (CD 4)",11,10,7,0,28
"Richmond City",-,"908 - Nine Hundred Eight (CD 4)",12,11,20,0,43
"Richmond City",-,"909 - Nine Hundred Nine (CD 4)",20,17,16,0,53
"Richmond City",-,"910 - Nine Hundred Ten (CD 4)",21,21,13,0,55
"Richmond City",-,"911 - Nine Hundred Eleven (CD 4)",17,8,19,0,44
"Richmond City",-,"AB - Central Absentee Precinct (CD 4)",29,58,40,0,127
"Richmond City",-,"Provisional (CD 4)",0,0,0,0,0
"Roanoke County",-,"101 - Catawba (CD 9)",26,26,1,0,53
"Roanoke County",-,"102 - Mason Valley (CD 9)",23,18,3,0,44
"Roanoke County",-,"103 - Glenvar (CD 9)",37,58,4,0,99
"Roanoke County",-,"104 - Northside (CD 9)",30,26,3,0,59
"Roanoke County",-,"105 - Peters Creek (CD 9)",80,78,9,2,169
"Roanoke County",-,"106 - Green Hill (CD 9)",64,76,7,0,147
"Roanoke County",-,"107 - Bennett Springs (CD 9)",33,23,3,0,59
"Roanoke County",-,"108 - Wildwood (CD 9)",28,25,4,0,57
"Roanoke County",-,"201 - Plantation (CD 6)",53,43,7,0,103
"Roanoke County",-,"202 - Burlington (CD 6)",36,21,7,0,64
"Roanoke County",-,"203 - Mountain View (CD 6)",107,73,18,0,198
"Roanoke County",-,"204 - Botetourt Springs (CD 9)",64,50,19,0,133
"Roanoke County",-,"205 - Orchards (CD 6)",103,97,17,0,217
"Roanoke County",-,"206 - Hollins (CD 6)",48,11,11,0,70
"Roanoke County",-,"301 - Bent Mountain (CD 9)",30,15,6,1,52
"Roanoke County",-,"302 - Poages Mill (CD 6)",72,122,14,0,208
"Roanoke County",-,"303 - Windsor Hills (CD 6)",44,44,7,0,95
"Roanoke County",-,"304 - Oak Grove (CD 6)",111,82,26,0,219
"Roanoke County",-,"305 - Castle Rock (CD 6)",82,93,24,0,199
"Roanoke County",-,"306 - Garst Mill (CD 6)",42,33,7,0,82
"Roanoke County",-,"402 - Bonsack (CD 6)",23,12,2,0,37
"Roanoke County",-,"403 - North Vinton (CD 6)",45,26,8,0,79
"Roanoke County",-,"404 - South Vinton (CD 6)",43,50,2,1,96
"Roanoke County",-,"405 - Lindenwood (CD 6)",95,98,20,0,213
"Roanoke County",-,"406 - Mount Pleasant (CD 6)",69,53,6,0,128
"Roanoke County",-,"501 - Cotton Hill (CD 6)",40,41,4,0,85
"Roanoke County",-,"502 - Penn Forest (CD 6)",25,65,8,1,99
"Roanoke County",-,"503 - Cave Spring (CD 6)",47,73,8,0,128
"Roanoke County",-,"504 - Ogden (CD 6)",35,21,5,0,61
"Roanoke County",-,"505 - Clearbrook (CD 6)",55,34,4,0,93
"Roanoke County",-,"506 - Mount Vernon (CD 6)",37,22,7,0,66
"Roanoke County",-,"507 - Hunting Hills (CD 6)",52,90,12,0,154
"Roanoke County",-,"Ab - Central Absentee Precinct (CD 6)",34,22,10,1,67
"Roanoke County",-,"Ab - Central Absentee Precinct (CD 9)",16,8,4,0,28
"Roanoke County",-,"Provisional (CD 6)",0,0,0,0,0
"Roanoke County",-,"Provisional (CD 9)",0,0,0,0,0
"Roanoke City",-,"1 -Peters Creek",9,8,7,0,24
"Roanoke City",-,"2 - Grandview",42,31,11,0,84
"Roanoke City",-,"3 -Preston Park",59,31,14,0,104
"Roanoke City",-,"4 - Williamson Road",48,12,5,0,65
"Roanoke City",-,"5 - East Gate",51,31,9,0,91
"Roanoke City",-,"6 - Hollins Road",30,23,4,0,57
"Roanoke City",-,"7 - Southeast",40,19,9,0,68
"Roanoke City",-,"8 - Lincoln Terrace",4,1,5,0,10
"Roanoke City",-,"9 - Highland",24,14,4,0,42
"Roanoke City",-,"10 - Old Southwest-Wasena",35,40,5,0,80
"Roanoke City",-,"11 - Raleigh Court",49,68,6,0,123
"Roanoke City",-,"12 - South Roanoke",30,101,15,0,146
"Roanoke City",-,"13 - Garden City",61,36,8,0,105
"Roanoke City",-,"14 - Crystal Spring",44,93,11,0,148
"Roanoke City",-,"15 - Grandin Court",53,51,16,0,120
"Roanoke City",-,"16 - Deyerle",79,81,16,0,176
"Roanoke City",-,"17 - Lee-Hi",50,37,6,0,93
"Roanoke City",-,"18 - Summit Hills",49,41,4,0,94
"Roanoke City",-,"19 - Forest Park",7,4,1,0,12
"Roanoke City",-,"20 - Eureka Park",9,5,2,0,16
"Roanoke City",-,"Ab - Central Absentee Precinct",19,20,9,0,48
"Roanoke City",-,Provisional,0,0,0,0,0
"Rockbridge County",-,"101 - Airport",38,34,11,0,83
"Rockbridge County",-,"102 - Ben Salem",34,24,6,0,64
"Rockbridge County",-,"103 - Plank Road",24,15,3,0,42
"Rockbridge County",-,"104 - Effinger",18,15,1,0,34
"Rockbridge County",-,"201 - Collierstown",20,27,7,0,54
"Rockbridge County",-,"202 - Highland Belle",60,59,26,0,145
"Rockbridge County",-,"203 - Vo-tech",12,16,6,0,34
"Rockbridge County",-,"301 - Maury River",27,3,8,0,38
"Rockbridge County",-,"302 - Natural Bridge",29,9,6,0,44
"Rockbridge County",-,"303 - Falling Spring",17,11,3,0,31
"Rockbridge County",-,"401 - Fairfield",24,22,4,0,50
"Rockbridge County",-,"402 - Mountain View",41,18,9,0,68
"Rockbridge County",-,"403 - Vesuvius",20,7,4,0,31
"Rockbridge County",-,"501 - Goshen",25,6,5,0,36
"Rockbridge County",-,"502 - Meadowview",16,18,12,0,46
"Rockbridge County",-,"503 - Rockbridge Baths",14,10,10,0,34
"Rockbridge County",-,"504 - Rockbridge",42,20,12,0,74
"Rockbridge County",-,"Ab - Central Absentee Precinct",10,20,6,0,36
"Rockbridge County",-,Provisional,0,0,0,0,0
"Rockingham County",-,"101 - Broadway",84,66,15,0,165
"Rockingham County",-,"102 - Timberville",27,15,3,0,45
"Rockingham County",-,"103 - Fulks Run",52,32,5,0,89
"Rockingham County",-,"104 - Bergton",27,24,5,0,56
"Rockingham County",-,"105 - Lacey Spring",37,30,3,0,70
"Rockingham County",-,"106 - Tenth Legion",37,16,6,0,59
"Rockingham County",-,"107 - Plains",42,27,10,0,79
"Rockingham County",-,"108 - Little North Mountain",31,14,1,0,46
"Rockingham County",-,"201 - Singers Glen",28,36,17,0,81
"Rockingham County",-,"202 - Edom",87,45,16,0,148
"Rockingham County",-,"203 - Dayton",44,21,12,0,77
"Rockingham County",-,"204 - Mt Clinton",68,29,15,0,112
"Rockingham County",-,"205 - Silver Lake",76,43,20,0,139
"Rockingham County",-,"301 - Keezletown",40,29,10,0,79
"Rockingham County",-,"302 - Port Republic",71,35,16,0,122
"Rockingham County",-,"303 - Melrose",34,17,9,0,60
"Rockingham County",-,"304 - Grottoes",69,19,7,0,95
"Rockingham County",-,"305 - Massanetta Springs",54,47,13,0,114
"Rockingham County",-,"306 - Cross Keys",41,14,11,0,66
"Rockingham County",-,"307 - Crossroads",93,69,32,0,194
"Rockingham County",-,"401 - Bridgewater",92,81,33,0,206
"Rockingham County",-,"402 - Montezuma",50,31,18,0,99
"Rockingham County",-,"403 - Mt Crawford",7,9,5,0,21
"Rockingham County",-,"404 - North River",69,23,18,0,110
"Rockingham County",-,"405 - Ottobine",60,35,10,0,105
"Rockingham County",-,"501 - Elkton",65,21,10,0,96
"Rockingham County",-,"502 - Swift Run",90,32,11,0,133
"Rockingham County",-,"503 - Mcgaheysville",69,46,10,0,125
"Rockingham County",-,"504 - South Fork",44,19,2,0,65
"Rockingham County",-,"505 - Stony Run",59,33,18,0,110
"Rockingham County",-,"Ab - Central Absentee Precinct",73,46,17,0,136
"Rockingham County",-,Provisional,1,1,0,0,2
"Russell County",-,"101 - Moccasin",12,12,1,0,25
"Russell County",-,"102 - Copper Creek",12,5,0,0,17
"Russell County",-,"103 - South Castlewood",6,6,1,0,13
"Russell County",-,"201 - North Castlewood",29,13,3,0,45
"Russell County",-,"202 - Dante",6,5,0,0,11
"Russell County",-,"301 - Cooks Mill",3,0,0,0,3
"Russell County",-,"302 - Daugherty",3,6,3,0,12
"Russell County",-,"303 - New Garden",12,1,2,0,15
"Russell County",-,"304 - Cleveland",8,2,0,0,10
"Russell County",-,"401 - Drill",2,1,0,0,3
"Russell County",-,"402 - Swords Creek",34,6,1,0,41
"Russell County",-,"403 - Honaker",9,3,1,0,13
"Russell County",-,"501 - West Lebanon",33,16,3,0,52
"Russell County",-,"601 - East Lebanon",22,9,1,0,32
"Russell County",-,"602 - Elk Garden",21,18,5,0,44
"Russell County",-,"Ab - Central Absentee Precinct",13,8,5,0,26
"Russell County",-,Provisional,0,0,0,0,0
"Salem City",-,"1 - North Salem No 2",60,49,14,0,123
"Salem City",-,"2 - Conehurst",13,23,2,0,38
"Salem City",-,"3 - Beverly Heights",26,32,7,0,65
"Salem City",-,"4 - West Salem",40,35,8,0,83
"Salem City",-,"5 - North Salem No 1",28,48,9,0,85
"Salem City",-,"6 - South Salem No 1",17,17,3,0,37
"Salem City",-,"7 - South Salem No 2",36,18,7,0,61
"Salem City",-,"8 - East Salem",13,15,3,0,31
"Salem City",-,"9 - South Side Hills",62,54,4,0,120
"Salem City",-,"10 - Hidden Valley",46,60,8,0,114
"Salem City",-,"Ab - Central Absentee Precinct",11,8,3,0,22
"Salem City",-,Provisional,0,0,0,0,0
"Scott County",-,"101 - Weber City",25,15,1,0,41
"Scott County",-,"102 - Yuma",19,5,4,0,28
"Scott County",-,"202 - Weber City East",17,5,1,0,23
"Scott County",-,"203 - Hiltons",18,14,0,0,32
"Scott County",-,"204 - Clark's",12,0,0,0,12
"Scott County",-,"301 - Nickelsville",32,2,0,0,34
"Scott County",-,"302 - Snowflake",18,5,1,0,24
"Scott County",-,"303 - Twin Springs",10,1,0,0,11
"Scott County",-,"304 - Copper Creek",1,0,0,0,1
"Scott County",-,"401 - Gate City",32,38,1,0,71
"Scott County",-,"501 - Dungannon",9,2,1,0,12
"Scott County",-,"502 - Fort Blackmore",19,0,0,0,19
"Scott County",-,"503 - Manville",0,6,3,0,9
"Scott County",-,"504 - Rye Cove",36,11,3,0,50
"Scott County",-,"601 - Clinchport",10,6,0,0,16
"Scott County",-,"602 - Duffield-pattonsville",15,9,3,0,27
"Scott County",-,"603 - Fairview",1,5,0,0,6
"Scott County",-,"Ab - Central Absentee Precinct",15,0,0,0,15
"Scott County",-,Provisional,0,0,0,0,0
"Shenandoah County",-,"101 - Orkney Springs",44,53,19,0,116
"Shenandoah County",-,"103 - New Market",106,76,17,0,199
"Shenandoah County",-,"201 - Conicville",80,45,11,0,136
"Shenandoah County",-,"202 - Mt Jackson",57,40,14,0,111
"Shenandoah County",-,"302 - Edinburg",62,59,27,0,148
"Shenandoah County",-,"303 - St Luke",77,57,21,0,155
"Shenandoah County",-,"304 - Fort Valley",57,40,18,0,115
"Shenandoah County",-,"401 - Woodstock",98,115,29,0,242
"Shenandoah County",-,"501 - Cedar Creek",8,7,0,0,15
"Shenandoah County",-,"503 - Toms Brook",110,51,28,0,189
"Shenandoah County",-,"504 - Lebanon Church",80,32,10,0,122
"Shenandoah County",-,"601 - Strasburg",130,66,33,0,229
"Shenandoah County",-,"Ab - Central Absentee Precinct",25,18,5,0,48
"Shenandoah County",-,Provisional,0,0,0,0,0
"Smyth County",-,"101 - Saltville",71,7,0,0,78
"Smyth County",-,"201 - Seven Mile Ford",45,11,4,0,60
"Smyth County",-,"202 - Rich Valley",17,3,0,0,20
"Smyth County",-,"301 - Chilhowie",54,8,10,0,72
"Smyth County",-,"302 - St Clair",11,5,1,0,17
"Smyth County",-,"401 - East Park",39,14,1,0,54
"Smyth County",-,"402 - West Park",18,10,4,0,32
"Smyth County",-,"501 - Atkins",37,10,2,0,49
"Smyth County",-,"502 - Wassona",39,11,0,0,50
"Smyth County",-,"601 - Royal Oak East",29,7,1,0,37
"Smyth County",-,"602 - Royal Oak West",14,2,1,0,17
"Smyth County",-,"701 - Adwolfe",45,10,0,0,55
"Smyth County",-,"702 - Sugar Grove",22,7,1,0,30
"Smyth County",-,"703 - Konnarock",10,7,1,0,18
"Smyth County",-,"Ab - Central Absentee Precinct",12,3,0,0,15
"Smyth County",-,Provisional,0,0,0,0,0
"Southampton County",-,"101 - Berlin",23,25,10,0,58
"Southampton County",-,"102 - Ivor",38,40,7,0,85
"Southampton County",-,"201 - Boykins",18,10,2,0,30
"Southampton County",-,"202 - Branchville",20,3,4,0,27
"Southampton County",-,"301 - Capron",22,23,7,0,52
"Southampton County",-,"302 - Sebrell",22,20,3,0,45
"Southampton County",-,"401 - Drewryville",8,10,9,0,27
"Southampton County",-,"501 - Hunterdale",56,17,7,0,80
"Southampton County",-,"502 - Forks-of-the-river",16,8,2,0,26
"Southampton County",-,"601 - Courtland",27,17,9,0,53
"Southampton County",-,"602 - Sedley",41,17,2,0,60
"Southampton County",-,"701 - Blackwater River",18,5,5,0,28
"Southampton County",-,"702 - Newsoms",21,7,2,0,30
"Southampton County",-,"Ab - Central Absentee Precinct",7,7,1,0,15
"Southampton County",-,Provisional,0,0,0,0,0
"Spotsylvania County",-,"101 - Partlow (CD 7)",86,68,14,0,168
"Spotsylvania County",-,"102 - Blaydes Corner (CD 7)",77,56,3,0,136
"Spotsylvania County",-,"103 - Travelers Rest (CD 1)",0,0,0,0,0
"Spotsylvania County",-,"103 - Travelers Rest (CD 7)",84,59,11,0,154
"Spotsylvania County",-,"104 - Massaponax (CD 1)",62,74,19,0,155
"Spotsylvania County",-,"201 - Wilderness School (CD 7)",93,48,9,0,150
"Spotsylvania County",-,"202 - Wilderness Fire (CD 7)",98,92,11,0,201
"Spotsylvania County",-,"203 - Ni River / Elys Ford (CD 7)",71,61,11,0,143
"Spotsylvania County",-,"204 - Chancellor (CD 7)",65,64,6,0,135
"Spotsylvania County",-,"301 - Plank Road (CD 7)",81,88,19,0,188
"Spotsylvania County",-,"302 - Hazel Run (CD 7)",75,72,19,0,166
"Spotsylvania County",-,"303 - Riverbend (CD 7)",152,125,31,0,308
"Spotsylvania County",-,"401 - Summit (CD 1)",67,84,14,0,165
"Spotsylvania County",-,"402 - Parkside (CD 1)",52,33,12,0,97
"Spotsylvania County",-,"402 - Parkside (CD 7)",13,8,2,0,23
"Spotsylvania County",-,"403 - Lee Hill (CD 1)",73,106,40,0,219
"Spotsylvania County",-,"501 - Belmont (CD 7)",60,77,9,0,146
"Spotsylvania County",-,"502 - Brokenburg (CD 7)",45,65,3,0,113
"Spotsylvania County",-,"503 - Post Oak (CD 7)",63,64,2,0,129
"Spotsylvania County",-,"504 - Courthouse (CD 7)",85,116,12,0,213
"Spotsylvania County",-,"505 - Brock (CD 7)",125,133,23,0,281
"Spotsylvania County",-,"601 - Salem (CD 7)",87,86,15,0,188
"Spotsylvania County",-,"602 - Smith Station (CD 7)",90,88,13,0,191
"Spotsylvania County",-,"603 - Piedmont (CD 7)",38,68,3,0,109
"Spotsylvania County",-,"701 - Battlefield (CD 1)",67,50,10,0,127
"Spotsylvania County",-,"702 - Brents Mill (CD 1)",24,43,4,0,71
"Spotsylvania County",-,"702 - Brents Mill (CD 7)",51,39,14,0,104
"Spotsylvania County",-,"703 - Fairview (CD 1)",14,6,0,0,20
"Spotsylvania County",-,"703 - Fairview (CD 7)",15,26,2,0,43
"Spotsylvania County",-,"704 - Gayle (CD 1)",75,45,6,0,126
"Spotsylvania County",-,"704 - Gayle (CD 7)",55,65,13,0,133
"Spotsylvania County",-,"Ab - Central Absentee Precinct (CD 1)",19,12,3,0,34
"Spotsylvania County",-,"Ab - Central Absentee Precinct (CD 7)",60,51,11,0,122
"Spotsylvania County",-,"Provisional (CD 1)",0,0,0,0,0
"Spotsylvania County",-,"Provisional (CD 7)",0,0,1,0,1
"Stafford County",-,"101 - Hartwood",276,105,23,0,404
"Stafford County",-,"102 - Rocky Run",121,51,16,0,188
"Stafford County",-,"103 - Simpson",109,71,9,0,189
"Stafford County",-,"104 - College",119,91,13,0,223
"Stafford County",-,"201 - Rock Hill",87,71,15,0,173
"Stafford County",-,"202 - Roseville",103,65,8,0,176
"Stafford County",-,"203 - Ruby",129,89,13,0,231
"Stafford County",-,"204 - Stefaniga",154,77,11,0,242
"Stafford County",-,"301 - Griffis",43,33,7,0,83
"Stafford County",-,"302 - Widewater",82,43,9,0,134
"Stafford County",-,"303 - Harbour",95,71,10,0,176
"Stafford County",-,"304 - Barrett",42,22,5,0,69
"Stafford County",-,"401 - Aquia",20,15,7,0,42
"Stafford County",-,"402 - Courthouse",80,69,12,0,161
"Stafford County",-,"403 - Brooke",175,83,15,0,273
"Stafford County",-,"404 - Government Island",126,77,18,0,221
"Stafford County",-,"501 - Grafton",137,89,11,0,237
"Stafford County",-,"502 - Falmouth",116,71,19,0,206
"Stafford County",-,"503 - Drew",90,48,17,0,155
"Stafford County",-,"504 - Gayle",137,53,9,0,199
"Stafford County",-,"601 - Ferry Farm",119,63,8,0,190
"Stafford County",-,"602 - Chatham",91,103,17,0,211
"Stafford County",-,"603 - White Oak",124,89,21,0,234
"Stafford County",-,"604 - England Run",31,15,3,0,49
"Stafford County",-,"701 - Woodlands",120,79,10,0,209
"Stafford County",-,"702 - Whitson",88,57,13,0,158
"Stafford County",-,"703 - Hampton",136,95,21,0,252
"Stafford County",-,"Ab - Central Absentee Precinct",73,46,17,0,136
"Stafford County",-,Provisional,4,1,0,0,5
"Staunton City",-,"101 - Ward No 1",78,31,14,0,123
"Staunton City",-,"201 - Ward Two",103,35,14,0,152
"Staunton City",-,"301 - Ward No 3",74,29,17,0,120
"Staunton City",-,"401 - Ward No 4",60,54,14,0,128
"Staunton City",-,"501 - Ward No 5",37,48,10,0,95
"Staunton City",-,"Ab - Central Absentee Precinct",14,6,4,0,24
"Staunton City",-,Provisional,0,0,0,0,0
"Suffolk City",-,"101 - Belleharbour (CD 3)",19,21,3,0,43
"Suffolk City",-,"102 - Driver (CD 3)",122,113,74,0,309
"Suffolk City",-,"104 - Bennetts Creek (CD 3)",53,64,27,0,144
"Suffolk City",-,"201 - Ebenezer (CD 3)",79,71,38,0,188
"Suffolk City",-,"202 - Chuckatuck (CD 3)",83,67,29,0,179
"Suffolk City",-,"203 - Kings Fork (CD 3)",37,33,26,0,96
"Suffolk City",-,"204 - Hillpoint (CD 3)",31,27,18,0,76
"Suffolk City",-,"301 - White Marsh (CD 4)",20,10,12,0,42
"Suffolk City",-,"302 - John F Kennedy (CD 3)",16,4,3,0,23
"Suffolk City",-,"302 - John F Kennedy (CD 4)",2,0,3,0,5
"Suffolk City",-,"304 - Nansemond River (CD 3)",35,40,28,0,103
"Suffolk City",-,"305 - Shoulders Hill (CD 3)",19,17,8,0,44
"Suffolk City",-,"401 - Airport (CD 4)",41,20,28,0,89
"Suffolk City",-,"402 - Whaleyville (CD 4)",64,70,17,0,151
"Suffolk City",-,"403 - Southside (CD 4)",5,2,0,0,7
"Suffolk City",-,"404 - Booker T Washington (CD 3)",0,1,1,0,2
"Suffolk City",-,"404 - Booker T Washington (CD 4)",7,4,2,0,13
"Suffolk City",-,"405 - Pittmantown (CD 4)",18,17,13,0,48
"Suffolk City",-,"501 - Kilbys Mill (CD 4)",59,83,18,0,160
"Suffolk City",-,"502 - Holland (CD 4)",57,73,20,0,150
"Suffolk City",-,"504 - Lake Cohoon (CD 3)",29,35,16,0,80
"Suffolk City",-,"504 - Lake Cohoon (CD 4)",55,75,23,0,153
"Suffolk City",-,"601 - Lakeside (CD 4)",54,46,42,0,142
"Suffolk City",-,"602 - Olde Towne (CD 3)",4,0,8,0,12
"Suffolk City",-,"602 - Olde Towne (CD 4)",0,0,0,0,0
"Suffolk City",-,"603 - Elephants Fork/westhaven (CD 4)",23,13,8,0,44
"Suffolk City",-,"604 - Wilroy (CD 3)",28,28,11,0,67
"Suffolk City",-,"605 - Hollywood (CD 3)",4,1,19,0,24
"Suffolk City",-,"702 - Harbourview (CD 3)",60,56,25,0,141
"Suffolk City",-,"704 - Burbage Grant (CD 3)",40,40,30,0,110
"Suffolk City",-,"706 - Huntersville (CD 3)",12,17,13,0,42
"Suffolk City",-,"AB - Central Absentee Precinct (CD 3)",19,18,14,0,51
"Suffolk City",-,"Ab - Central Absentee Precinct (CD 4)",12,8,5,0,25
"Suffolk City",-,"Provisional (CD 3)",0,0,0,0,0
"Suffolk City",-,"Provisional (CD 4)",0,0,0,0,0
"Surry County",-,"101 - Surry",52,31,13,0,96
"Surry County",-,"201 - Bacons Castle",18,21,8,0,47
"Surry County",-,"301 - Dendron",23,12,24,0,59
"Surry County",-,"302 - Walls Bridge",10,7,5,0,22
"Surry County",-,"401 - Carsley",17,10,10,0,37
"Surry County",-,"501 - Claremont",33,32,6,0,71
"Surry County",-,"502 - Spring Grove",5,2,4,0,11
"Surry County",-,Provisional,0,0,0,0,0
"Sussex County",-,"101 - Waverly",13,17,8,0,38
"Sussex County",-,"201 - Stony Creek",17,12,10,0,39
"Sussex County",-,"202 - Little Mill",2,0,2,0,4
"Sussex County",-,"301 - Courthouse",35,27,4,0,66
"Sussex County",-,"302 - Wakefield",17,13,2,0,32
"Sussex County",-,"401 - Mars Hill",30,16,2,0,48
"Sussex County",-,"402 - West Wakefield",4,1,1,0,6
"Sussex County",-,"501 - Henry",9,3,0,0,12
"Sussex County",-,"502 - Yale",9,4,4,0,17
"Sussex County",-,"601 - Blackwater",26,16,2,0,44
"Sussex County",-,"602 - Newville",9,4,0,0,13
"Sussex County",-,"AB - Central Absentee Precinct",9,4,4,0,17
"Sussex County",-,Provisional,0,0,0,0,0
"Tazewell County",-,"101 - Abbs Valley",12,3,0,0,15
"Tazewell County",-,"102 - Tip Top",20,4,4,0,28
"Tazewell County",-,"103 - Boissevain",10,1,4,0,15
"Tazewell County",-,"104 - Falls Mills",18,3,5,0,26
"Tazewell County",-,"106 - Pocahontas",9,3,1,0,13
"Tazewell County",-,"107 - Amonate",3,1,1,0,5
"Tazewell County",-,"109 - Bishop",13,1,1,0,15
"Tazewell County",-,"110 - Adria",22,4,1,0,27
"Tazewell County",-,"111 - Gap Store",12,11,1,0,24
"Tazewell County",-,"112 - Bandy",8,10,7,0,25
"Tazewell County",-,"203 - Burkes Garden",8,4,2,0,14
"Tazewell County",-,"204 - Clear Fork",18,7,4,0,29
"Tazewell County",-,"207 - Freestone",13,3,1,0,17
"Tazewell County",-,"209 - Jeffersonville",101,29,8,0,138
"Tazewell County",-,"214 - Thompson Valley",24,8,1,0,33
"Tazewell County",-,"301 - Cedar Bluff",60,34,2,0,96
"Tazewell County",-,"302 - Baptist Valley",13,6,1,0,20
"Tazewell County",-,"303 - Wardell",30,14,4,0,48
"Tazewell County",-,"305 - Pounding Mill",16,5,2,0,23
"Tazewell County",-,"401 - Richlands",84,31,5,0,120
"Tazewell County",-,"402 - Jewell Ridge",10,2,1,0,13
"Tazewell County",-,"404 - Raven",18,7,2,0,27
"Tazewell County",-,"501 - Springville",61,25,4,0,90
"Tazewell County",-,"502 - Graham",114,40,8,1,163
"Tazewell County",-,"Ab - Central Absentee Precinct",26,24,3,0,53
"Tazewell County",-,Provisional,0,0,0,0,0
"Virginia Beach City",-,"1 - North Beach",127,258,49,0,434
"Virginia Beach City",-,"2 - South Beach",73,114,21,0,208
"Virginia Beach City",-,"3 - Ocean Lakes",42,105,15,0,162
"Virginia Beach City",-,"4 - Linkhorn",138,155,41,0,334
"Virginia Beach City",-,"5 - Seatack",58,55,14,0,127
"Virginia Beach City",-,"6 - Alanton",99,267,32,0,398
"Virginia Beach City",-,"7 - Kingston",105,152,35,0,292
"Virginia Beach City",-,"8 - London Bridge",97,110,35,0,242
"Virginia Beach City",-,"9 - Trantwood",141,180,68,0,389
"Virginia Beach City",-,"10 - Great Neck",127,314,35,0,476
"Virginia Beach City",-,"11 - Cape Henry",118,180,48,0,346
"Virginia Beach City",-,"12 - Plaza",94,103,31,0,228
"Virginia Beach City",-,"13 - Mt Trashmore",163,173,50,0,386
"Virginia Beach City",-,"14 - Malibu",81,111,26,0,218
"Virginia Beach City",-,"15 - Old Donation",62,57,21,0,140
"Virginia Beach City",-,"16 - Aragona",106,106,46,0,258
"Virginia Beach City",-,"17 - Ocean Park",62,161,14,0,237
"Virginia Beach City",-,"18 - Thoroughgood",133,208,65,0,406
"Virginia Beach City",-,"19 - Lake Smith",62,116,20,0,198
"Virginia Beach City",-,"20 - Bayside",100,103,18,0,221
"Virginia Beach City",-,"21 - Davis Corner",32,27,16,0,75
"Virginia Beach City",-,"22 - Point O View",127,143,44,0,314
"Virginia Beach City",-,"23 - Arrowhead",135,109,30,0,274
"Virginia Beach City",-,"24 - Larkspur",94,104,22,0,220
"Virginia Beach City",-,"25 - Avalon",146,131,55,0,332
"Virginia Beach City",-,"26 - Fairfield",169,110,54,0,333
"Virginia Beach City",-,"27 - Edwin",167,168,42,0,377
"Virginia Beach City",-,"28 - Thalia",84,140,29,0,253
"Virginia Beach City",-,"29 - Holland",52,73,18,0,143
"Virginia Beach City",-,"30 - Red Wing",107,151,45,0,303
"Virginia Beach City",-,"31 - Sigma",86,201,39,0,326
"Virginia Beach City",-,"32 - Creeds",70,99,24,0,193
"Virginia Beach City",-,"33 - Capps Shop",68,110,17,0,195
"Virginia Beach City",-,"34 - Blackwater",46,47,11,0,104
"Virginia Beach City",-,"35 - Courthouse",172,232,63,0,467
"Virginia Beach City",-,"36 - Windsor Oaks",108,110,28,0,246
"Virginia Beach City",-,"37 - Chesapeake Beach",58,98,27,0,183
"Virginia Beach City",-,"38 - Witchduck",198,241,82,0,521
"Virginia Beach City",-,"39 - Pembroke",126,144,23,0,293
"Virginia Beach City",-,"40 - Bonney",73,90,17,0,180
"Virginia Beach City",-,"41 - College Park",53,49,36,0,138
"Virginia Beach City",-,"42 - Brandon",95,85,72,1,253
"Virginia Beach City",-,"43 - Bellamy",50,53,21,0,124
"Virginia Beach City",-,"44 - Centerville",101,126,59,0,286
"Virginia Beach City",-,"45 - Timberlake",48,58,6,0,112
"Virginia Beach City",-,"46 - Green Run",35,46,16,0,97
"Virginia Beach City",-,"47 - Kings Grant",160,227,83,0,470
"Virginia Beach City",-,"48 - Wolfsnare",148,181,42,0,371
"Virginia Beach City",-,"49 - Lynnhaven",129,219,42,0,390
"Virginia Beach City",-,"50 - Oceana",20,37,12,0,69
"Virginia Beach City",-,"51 - Stratford Chase",84,159,36,0,279
"Virginia Beach City",-,"52 - Homestead",180,150,75,0,405
"Virginia Beach City",-,"53 - Shannon",105,117,36,0,258
"Virginia Beach City",-,"54 - Cromwell",55,67,35,0,157
"Virginia Beach City",-,"55 - Magic Hollow",33,48,12,0,93
"Virginia Beach City",-,"56 - Edinburgh",62,79,27,0,168
"Virginia Beach City",-,"57 - Sherry Park",64,76,24,0,164
"Virginia Beach City",-,"58 - Glenwood",79,101,30,0,210
"Virginia Beach City",-,"59 - Shelton Park",63,76,20,0,159
"Virginia Beach City",-,"60 - Foxfire",89,178,34,0,301
"Virginia Beach City",-,"61 - Baker",8,12,9,0,29
"Virginia Beach City",-,"62 - Landstown",109,128,61,0,298
"Virginia Beach City",-,"63 - Culver",84,166,23,0,273
"Virginia Beach City",-,"64 - Rosemont Forest",94,102,26,0,222
"Virginia Beach City",-,"65 - Colonial",73,57,30,0,160
"Virginia Beach City",-,"66 - Hunt",97,127,30,0,254
"Virginia Beach City",-,"67 - Eastern Shore",30,42,10,0,82
"Virginia Beach City",-,"68 - Manor",163,128,53,0,344
"Virginia Beach City",-,"69 - Shell",48,29,33,0,110
"Virginia Beach City",-,"70 - Corporate Landing",70,97,24,0,191
"Virginia Beach City",-,"71 - Round Hill",37,46,17,0,100
"Virginia Beach City",-,"72 - Rudee",85,145,31,0,261
"Virginia Beach City",-,"73 - Dahlia",46,41,27,0,114
"Virginia Beach City",-,"74 - Buckner",41,44,19,0,104
"Virginia Beach City",-,"75 - Colony",166,197,43,0,406
"Virginia Beach City",-,"76 - Village",36,24,20,0,80
"Virginia Beach City",-,"77 - Brookwood",68,96,36,0,200
"Virginia Beach City",-,"78 - Indian Lakes",86,85,39,0,210
"Virginia Beach City",-,"79 - Pleasant Hall",38,45,17,0,100
"Virginia Beach City",-,"80 - Chimney Hill",40,44,16,0,100
"Virginia Beach City",-,"81 - Rock Lake",65,64,37,0,166
"Virginia Beach City",-,"82 - Shelburne",64,88,32,0,184
"Virginia Beach City",-,"83 - Strawbridge",99,144,40,0,283
"Virginia Beach City",-,"84 - Tallwood",64,63,37,0,164
"Virginia Beach City",-,"85 - Upton",117,155,35,0,307
"Virginia Beach City",-,"86 - Haygood",126,133,56,0,315
"Virginia Beach City",-,"87 - Hillcrest",85,103,30,0,218
"Virginia Beach City",-,"88 - North Landing",67,79,27,0,173
"Virginia Beach City",-,"89 - Lake Christopher",98,116,44,0,258
"Virginia Beach City",-,"90 - Lake Joyce",59,122,16,0,197
"Virginia Beach City",-,"91 - Lexington",50,61,31,0,142
"Virginia Beach City",-,"92 - Little Neck",136,143,33,0,312
"Virginia Beach City",-,"93 - Newtown",20,14,13,0,47
"Virginia Beach City",-,"94 - Pinewood",51,58,18,0,127
"Virginia Beach City",-,"95 - Dam Neck",33,61,13,0,107
"Virginia Beach City",-,"96 - Hilltop",41,50,13,0,104
"Virginia Beach City",-,"97 - Indian River",36,62,20,0,118
"Virginia Beach City",-,"98 - Independence",27,45,10,0,82
"Virginia Beach City",-,"99 - Salem Woods",41,35,15,0,91
"Virginia Beach City",-,"100 - Sandbridge",63,93,18,0,174
"Virginia Beach City",-,"Ab - Central Absentee Precinct",371,280,86,1,738
"Virginia Beach City",-,Provisional,2,5,3,1,11
"Warren County",-,"101 - Fork Town",55,31,49,0,135
"Warren County",-,"102 - Otterburn",113,69,63,0,245
"Warren County",-,"201 - Happy Creek",84,65,70,0,219
"Warren County",-,"202 - Linden",84,51,39,0,174
"Warren County",-,"301 - North River",75,40,43,0,158
"Warren County",-,"302 - Riverton",79,40,73,0,192
"Warren County",-,"401 - East Shenandoah",140,82,66,0,288
"Warren County",-,"402 - Town - West Shenandoah",55,20,54,0,129
"Warren County",-,"501 - South River",86,45,45,0,176
"Warren County",-,"502 - Bentonville",56,22,19,0,97
"Warren County",-,"504 - Browntown",52,25,8,0,85
"Warren County",-,"Ab - Central Absentee Precinct",18,13,15,0,46
"Warren County",-,Provisional,0,1,0,0,1
"Washington County",-,"101 - East Abingdon",57,22,6,0,85
"Washington County",-,"102 - West Abingdon",31,11,1,0,43
"Washington County",-,"201 - Clinchburg",27,6,7,0,40
"Washington County",-,"202 - Greendale",43,10,4,0,57
"Washington County",-,"203 - Hayters Gap",19,5,0,0,24
"Washington County",-,"204 Woodland Hills",32,16,2,0,50
"Washington County",-,"301 - Watauga",64,27,1,0,92
"Washington County",-,"302 - South Abingdon",57,15,4,0,76
"Washington County",-,"401 - Glade Spring",48,12,3,0,63
"Washington County",-,"402 - Meadowview",44,19,5,0,68
"Washington County",-,"501 - Rhea Valley",64,15,4,0,83
"Washington County",-,"502 - Damascus",20,11,7,0,38
"Washington County",-,"504 - Green Cove",15,2,2,0,19
"Washington County",-,"601 - Burson Place",47,19,4,0,70
"Washington County",-,"602 - Mendota",13,10,2,0,25
"Washington County",-,"603 - Valley Institute",52,19,8,0,79
"Washington County",-,"701 - High Point",35,17,0,0,52
"Washington County",-,"702 - Wallace",18,6,0,0,24
"Washington County",-,"703 - John Battle",37,12,6,0,55
"Washington County",-,"Ab - Central Absentee Precinct",26,7,3,0,36
"Washington County",-,Provisional,0,0,0,0,0
"Waynesboro City",-,"1 - Ward A",33,21,12,0,66
"Waynesboro City",-,"2 - Ward B",90,106,18,0,214
"Waynesboro City",-,"3 - Ward C",81,46,12,0,139
"Waynesboro City",-,"4 - Ward D",125,112,33,0,270
"Waynesboro City",-,"Ab - Central Absentee Precinct",6,10,1,0,17
"Waynesboro City",-,Provisional,0,0,0,0,0
"Westmoreland County",-,"101 - Precinct 1-1",16,34,7,0,57
"Westmoreland County",-,"102 - Precinct 1-2",15,10,0,0,25
"Westmoreland County",-,"201 - Precinct 2-1",38,58,2,0,98
"Westmoreland County",-,"202 - Precinct 2-2",37,33,4,0,74
"Westmoreland County",-,"301 - Precinct 3-1",30,33,5,0,68
"Westmoreland County",-,"302 - Precinct 3-2",20,15,2,0,37
"Westmoreland County",-,"401 - Precinct 4-1",76,68,15,0,159
"Westmoreland County",-,"501 - Precinct 5-1",88,53,13,0,154
"Westmoreland County",-,"Ab - Central Absentee Precinct",8,13,5,0,26
"Westmoreland County",-,Provisional,0,0,0,0,0
"Williamsburg City",-,"1 - Stryker",109,94,57,0,260
"Williamsburg City",-,"2 - Matoaka",86,102,52,0,240
"Williamsburg City",-,"Ab - Central Absentee Precinct",15,18,8,0,41
"Williamsburg City",-,Provisional,0,0,0,0,0
"Winchester City",-,"101 - Merrimans",175,79,37,0,291
"Winchester City",-,"102 - Old Town",150,46,37,0,233
"Winchester City",-,"201 - Virginia Avenue",84,29,14,0,127
"Winchester City",-,"301 - War Memorial",103,37,30,0,170
"Winchester City",-,"401 - Frederick Douglass",58,16,14,0,88
"Winchester City",-,"402 - Rolling Hills",137,47,46,0,230
"Winchester City",-,"Ab - Central Absentee Precinct",26,21,8,0,55
"Winchester City",-,Provisional,0,0,0,0,0
"Wise County",-,"101 - Appalachia",9,9,1,0,19
"Wise County",-,"102 - Dorchester",14,6,2,0,22
"Wise County",-,"103 - Guest River Voting Place",7,1,1,0,9
"Wise County",-,"104 - West Pound",31,9,11,0,51
"Wise County",-,"201 - North Coeburn",16,5,4,0,25
"Wise County",-,"202 - Wise",45,19,10,0,74
"Wise County",-,"203 - East Pound",12,5,0,0,17
"Wise County",-,"301 - Big Stone Gap",41,14,8,0,63
"Wise County",-,"302 - East Stone Gap",41,10,12,0,63
"Wise County",-,"401 - Clinch Valley",24,9,5,0,38
"Wise County",-,"402 - South Coeburn",28,12,0,0,40
"Wise County",-,"403 - St Paul",10,4,3,0,17
"Wise County",-,"Ab - Central Absentee Precinct",7,3,0,0,10
"Wise County",-,Provisional,0,0,0,0,0
"Wythe County",-,"101 - Royal Oak",24,3,0,0,27
"Wythe County",-,"102 - Rural Retreat",117,25,10,0,152
"Wythe County",-,"203 - West Wytheville",99,21,3,0,123
"Wythe County",-,"303 - East Wytheville",105,41,10,0,156
"Wythe County",-,"401 - Fort Chiswell",64,13,4,0,81
"Wythe County",-,"402 - Max Meadows",71,15,3,0,89
"Wythe County",-,"501 - Jackson Memorial",32,7,1,0,40
"Wythe County",-,"502 - Sheffey",68,8,6,0,82
"Wythe County",-,"601 - Huddle",32,3,1,0,36
"Wythe County",-,"602 - Zion",49,5,2,0,56
"Wythe County",-,"603 Evergreen",30,16,2,0,48
"Wythe County",-,"Ab - Central Absentee Precinct",9,3,0,0,12
"Wythe County",-,Provisional,0,0,0,0,0
"York County",-,"101 - Queens Lake",94,134,34,1,263
"York County",-,"102 - Waller Mill",106,160,45,0,311
"York County",-,"103 - Magruder",58,89,22,0,169
"York County",-,"201 - Coventry",149,190,69,0,408
"York County",-,"202 - Kiln Creek",65,99,42,1,207
"York County",-,"301 - Seaford",195,302,54,0,551
"York County",-,"302 - Yorktown",123,197,41,0,361
"York County",-,"303 - Edgehill",99,160,32,0,291
"York County",-,"401 - Harwoods Mill",150,209,75,0,434
"York County",-,"402 - Dare",150,244,50,0,444
"York County",-,"403 - Grafton",61,134,27,0,222
"York County",-,"501 - Tabb",145,206,66,0,417
"York County",-,"502 - Bethel",97,156,44,0,297
"York County",-,"Ab - Central Absentee Precinct",90,56,31,0,177
"York County",-,Provisional,0,0,0,0,0
TOTALS,,,"136,610","131,321","36,508",79,"304,518"
