County/City,Ward,Pct,"Edward Walter Gillespie","Corey Alan Stewart","Frank W. Wagner","All Others","Total Votes Cast"
,,,,,
"Accomack County",-,"101 - Chincoteague",94,63,37,0,194
"Accomack County",-,"201 - Atlantic",40,57,16,0,113
"Accomack County",-,"202 - Greenbackville",48,47,13,0,108
"Accomack County",-,"301 - New Church",35,41,12,0,88
"Accomack County",-,"401 - Bloxom",26,32,6,0,64
"Accomack County",-,"402 - Parksley",33,31,13,0,77
"Accomack County",-,"403 - Saxis",11,17,4,0,32
"Accomack County",-,"501 - Mappsville",25,23,1,0,49
"Accomack County",-,"502 - Rue",6,16,2,0,24
"Accomack County",-,"601 - Accomac",64,53,13,0,130
"Accomack County",-,"602 - Tangier",31,49,25,0,105
"Accomack County",-,"701 - Nandua",76,92,26,0,194
"Accomack County",-,"801 - Bobtown",40,38,12,0,90
"Accomack County",-,"802 - Melfa",25,36,4,0,65
"Accomack County",-,"803 - Wachapreague",37,50,9,0,96
"Accomack County",-,"901 - Painter",95,61,16,0,172
"Accomack County",-,"Ab - Central Absentee Precinct",15,12,3,0,30
"Accomack County",-,Provisional,0,0,0,0,0
"Albemarle County",-,"101 - Woodbrook",87,85,24,0,196
"Albemarle County",-,"103 - Branchlands",35,18,7,0,60
"Albemarle County",-,"104 - Agnor-hurt",30,48,8,0,86
"Albemarle County",-,"105 - Dunlora",74,55,21,0,150
"Albemarle County",-,"106 - Northside",68,89,28,0,185
"Albemarle County",-,"201 - Jack Jouett",74,44,23,0,141
"Albemarle County",-,"202 - University Hall",26,7,6,0,39
"Albemarle County",-,"203 - Georgetown",32,31,10,0,73
"Albemarle County",-,"204 - Belfield",46,32,14,0,92
"Albemarle County",-,"301 - Ivy",109,87,33,0,229
"Albemarle County",-,"302 - Red Hill",46,92,15,0,153
"Albemarle County",-,"304 - East Ivy",52,19,5,0,76
"Albemarle County",-,"305 - Country Green",39,55,12,0,106
"Albemarle County",-,"306 - Porters",16,55,5,0,76
"Albemarle County",-,"307 - Yellow Mountain",10,10,11,0,31
"Albemarle County",-,"401 - Scottsville",42,72,3,0,117
"Albemarle County",-,"402 - Monticello",39,72,5,0,116
"Albemarle County",-,"405 - Cale",50,78,11,0,139
"Albemarle County",-,"406 - Stone Robinson",110,136,34,0,280
"Albemarle County",-,"501 - Keswick",27,58,9,0,94
"Albemarle County",-,"502 - Stony Point",53,65,19,0,137
"Albemarle County",-,"503 - Hollymead",54,66,26,0,146
"Albemarle County",-,"504 - Free Bridge",113,84,24,0,221
"Albemarle County",-,"506 - Baker-butler",80,124,18,0,222
"Albemarle County",-,"601 - Crozet",88,105,28,0,221
"Albemarle County",-,"602 - Free Union",43,30,6,0,79
"Albemarle County",-,"603 - Earlysville",87,106,24,0,217
"Albemarle County",-,"604 - Brownsville",122,90,33,0,245
"Albemarle County",-,"Ab - Central Absentee Precinct",74,45,19,0,138
"Albemarle County",-,Provisional,4,1,1,0,6
"Alexandria City",-,"101 - Ladrey Senior Building",99,33,12,0,144
"Alexandria City",-,"102 - City Hall",134,32,18,0,184
"Alexandria City",-,"103 - Lyles Crouch School",147,42,16,0,205
"Alexandria City",-,"104 - Durant Center",93,36,21,0,150
"Alexandria City",-,"105 - Lee Center",93,27,17,0,137
"Alexandria City",-,"106 - Cora Kelly Center",70,28,14,0,112
"Alexandria City",-,"107 - Mt Vernon Recreation Center",108,44,21,0,173
"Alexandria City",-,"108 - George Washington Middle Sch",111,42,22,0,175
"Alexandria City",-,"109 - Fire Department Headquarters",103,41,23,0,167
"Alexandria City",-,"110 - Charles Houston Center",60,18,14,0,92
"Alexandria City",-,"201 - Maury School",107,28,21,0,156
"Alexandria City",-,"202 - George Mason School",153,39,21,0,213
"Alexandria City",-,"203 - Agudas Achim Synagogue",87,43,7,0,137
"Alexandria City",-,"204 - Blessed Sacrament Church",157,31,22,0,210
"Alexandria City",-,"205 - Douglas Macarthur School",146,36,18,0,200
"Alexandria City",-,"206 - Chinquapin Park Recreation Ctr",81,36,12,0,129
"Alexandria City",-,"207 - Temple Beth El Synagogue",132,51,30,0,213
"Alexandria City",-,"208 - Nova Arts Center",45,22,5,0,72
"Alexandria City",-,"209 - James K Polk School",70,36,8,0,114
"Alexandria City",-,"210 - The Hermitage",70,26,7,0,103
"Alexandria City",-,"302 - Patrick Henry Rec Center",29,22,10,0,61
"Alexandria City",-,"303 - Charles E Beatley Library",39,40,9,0,88
"Alexandria City",-,"304 - Samuel Tucker School",50,24,10,0,84
"Alexandria City",-,"305 - John Adams School",44,29,6,0,79
"Alexandria City",-,"306 - William Ramsay School",27,31,11,0,69
"Alexandria City",-,"307 - South Port",57,47,14,0,118
"Alexandria City",-,"308 - Cameron Station Community Ctr",122,53,19,0,194
"Alexandria City",-,"Ab - Central Absentee Precinct",223,37,21,0,281
"Alexandria City",-,Provisional,6,2,0,0,8
"Alleghany County",-,"101 - Arritt",21,27,1,0,49
"Alleghany County",-,"103 - Dameron",19,9,1,0,29
"Alleghany County",-,"201 - Humpback Bridge",15,14,1,0,30
"Alleghany County",-,"202 - Dolly Ann",13,27,4,0,44
"Alleghany County",-,"301 - Callaghan",15,19,1,0,35
"Alleghany County",-,"302 - Griffith",27,31,1,0,59
"Alleghany County",-,"401 - Low Moor",19,14,4,0,37
"Alleghany County",-,"402 - Jackson Heights",15,26,8,0,49
"Alleghany County",-,"501 - Iron Gate",7,6,1,0,14
"Alleghany County",-,"502 - Peters Switch",24,15,12,0,51
"Alleghany County",-,"601 - District 1",37,21,6,0,64
"Alleghany County",-,"701 - District 2",6,22,3,0,31
"Alleghany County",-,"Ab - Central Absentee Precinct",2,4,2,0,8
"Alleghany County",-,Provisional,0,0,0,0,0
"Amelia County",-,"101 - Number One",52,66,6,0,124
"Amelia County",-,"201 - Number Two",72,90,11,0,173
"Amelia County",-,"301 - Number Three",69,89,6,0,164
"Amelia County",-,"401 - Number Four",60,94,8,0,162
"Amelia County",-,"501 - Number Five",65,102,4,0,171
"Amelia County",-,"Ab - Central Absentee Precinct",11,7,1,0,19
"Amelia County",-,Provisional,1,1,0,0,2
"Amherst County",-,"101 - Wright Shop",29,41,5,0,75
"Amherst County",-,"102 - New Glasgow",47,91,10,0,148
"Amherst County",-,"103 - Coolwell",26,59,2,0,87
"Amherst County",-,"201 - Court House",91,147,31,0,269
"Amherst County",-,"202 - Temperance",40,71,13,0,124
"Amherst County",-,"301 - Monroe",47,67,10,0,124
"Amherst County",-,"302 - Elon",113,159,31,0,303
"Amherst County",-,"303 - Pleasant View",39,33,7,0,79
"Amherst County",-,"401 - Amelon",121,151,26,0,298
"Amherst County",-,"402 - Lonco",26,35,9,0,70
"Amherst County",-,"501 - Madison",87,128,15,0,230
"Amherst County",-,"Ab - Central Absentee Precinct",28,10,4,0,42
"Amherst County",-,Provisional,0,0,0,0,0
"Appomattox County",-,"101 - Vera",36,55,10,0,101
"Appomattox County",-,"102 - Pamplin",48,65,29,0,142
"Appomattox County",-,"201 - Chap",19,29,2,0,50
"Appomattox County",-,"202 - Spout Spring",64,101,27,0,192
"Appomattox County",-,"301 - Us 460",50,53,10,0,113
"Appomattox County",-,"302 - Stonewall",47,72,26,1,146
"Appomattox County",-,"401 - Courthouse",71,83,13,0,167
"Appomattox County",-,"501 - Oakville",53,63,14,0,130
"Appomattox County",-,"502 - Agee",22,33,8,0,63
"Appomattox County",-,"Ab - Central Absentee Precinct",12,2,3,0,17
"Appomattox County",-,Provisional,0,1,0,0,1
"Arlington County",-,"1 - Arlington",35,22,4,0,61
"Arlington County",-,"2 - Ashton Heights",51,13,12,0,76
"Arlington County",-,"3 - Aurora Hills",69,38,19,0,126
"Arlington County",-,"4 - Ballston",63,24,10,0,97
"Arlington County",-,"5 - Barcroft",47,22,12,0,81
"Arlington County",-,"6 - Crystal City",55,18,21,0,94
"Arlington County",-,"7 - Cherrydale",61,29,12,0,102
"Arlington County",-,"8 - Hume",90,35,17,0,142
"Arlington County",-,"9 - Columbia",46,28,11,0,85
"Arlington County",-,"10 - Wilson",70,33,10,0,113
"Arlington County",-,"11 - East Falls Church",50,39,12,0,101
"Arlington County",-,"12 - Fairlington",92,24,26,0,142
"Arlington County",-,"13 - Glen Carlyn",19,22,6,0,47
"Arlington County",-,"14 - Clarendon",35,14,10,0,59
"Arlington County",-,"15 - Lyon Park",33,18,7,0,58
"Arlington County",-,"16 - Lyon Village",60,20,11,0,91
"Arlington County",-,"17 - Overlee Knolls",77,36,17,0,130
"Arlington County",-,"18 - Park Lane",77,28,15,0,120
"Arlington County",-,"19 - Rosslyn",53,15,9,0,77
"Arlington County",-,"20 - Thrifton",119,35,17,0,171
"Arlington County",-,"21 - Virginia Highlands",59,19,9,0,87
"Arlington County",-,"22 - Abingdon",72,30,16,0,118
"Arlington County",-,"23 - Westover",41,34,12,0,87
"Arlington County",-,"24 - Woodlawn",57,39,15,0,111
"Arlington County",-,"25 - Arlington Forest",65,29,9,0,103
"Arlington County",-,"26 - Fillmore",29,28,19,0,76
"Arlington County",-,"27 - Jefferson",61,30,13,0,104
"Arlington County",-,"28 - Wakefield",51,19,13,0,83
"Arlington County",-,"29 - Dominion Hills",64,22,8,0,94
"Arlington County",-,"30 - Glebe",28,17,9,0,54
"Arlington County",-,"31 - Lexington",80,31,21,0,132
"Arlington County",-,"32 - Oakridge",34,24,6,0,64
"Arlington County",-,"33 - Rock Spring",88,44,25,0,157
"Arlington County",-,"34 - Yorktown",63,32,13,0,108
"Arlington County",-,"35 - Madison",157,56,18,0,231
"Arlington County",-,"36 - Marshall",85,37,9,0,131
"Arlington County",-,"37 - Nottingham",70,37,16,0,123
"Arlington County",-,"38 - Arlington View",31,15,8,0,54
"Arlington County",-,"39 - Ashlawn",28,19,6,0,53
"Arlington County",-,"40 - Virginia Square",60,24,14,0,98
"Arlington County",-,"41 - Navy League",57,11,3,0,71
"Arlington County",-,"42 - Shirlington",40,18,3,0,61
"Arlington County",-,"43 - Campbell",8,15,3,0,26
"Arlington County",-,"44 - Dawson Terrace",29,12,6,0,47
"Arlington County",-,"45 - Buckingham",36,18,5,0,59
"Arlington County",-,"46 - Central",73,24,21,0,118
"Arlington County",-,"47 - Four Mile Run",28,8,10,0,46
"Arlington County",-,"48 - Ausa",33,18,4,0,55
"Arlington County",-,"49 - Monroe",33,5,10,0,48
"Arlington County",-,"50 - Crystal Plaza",48,19,10,0,77
"Arlington County",-,"51 - Taylor",23,11,5,0,39
"Arlington County",-,"52 - Gunston",37,13,10,0,60
"Arlington County",-,"53 - Met Park",48,18,12,0,78
"Arlington County",-,"54 - Garfield Park",35,3,6,0,44
"Arlington County",-,"Ab - Central Absentee Precinct",184,37,35,0,256
"Arlington County",-,Provisional,1,0,0,0,1
"Augusta County",-,"101 - Jolivue",42,76,6,0,124
"Augusta County",-,"102 - Stuarts Draft Elementary",36,59,11,0,106
"Augusta County",-,"103 - Verona",69,132,12,0,213
"Augusta County",-,"201 - Crimora",53,128,6,0,187
"Augusta County",-,"202 - New Hope",51,101,9,0,161
"Augusta County",-,"203 - Weyers Cave",89,94,18,0,201
"Augusta County",-,"301 - Fort Defiance",125,208,17,0,350
"Augusta County",-,"302 - North River",35,62,8,0,105
"Augusta County",-,"303 - Mount Solon",53,95,13,0,161
"Augusta County",-,"304 - Churchville Fire Station",41,79,10,0,130
"Augusta County",-,"401 - Buffalo Gap",24,80,9,0,113
"Augusta County",-,"402 - Churchville Elementary",47,90,11,0,148
"Augusta County",-,"403 - Craigsville",26,50,5,0,81
"Augusta County",-,"404 - Deerfield",15,38,4,0,57
"Augusta County",-,"405 - Cedar Green",56,110,9,0,175
"Augusta County",-,"501 - Greenville",60,103,16,0,179
"Augusta County",-,"502 - Middlebrook",32,78,8,0,118
"Augusta County",-,"503 - Spottswood",41,74,6,0,121
"Augusta County",-,"504 - White Hill",109,135,10,0,254
"Augusta County",-,"601 - Sherando",56,94,15,1,166
"Augusta County",-,"602 - Ridgeview",127,221,23,0,371
"Augusta County",-,"603 - Lyndhurst",102,137,13,0,252
"Augusta County",-,"801 - Dooms",63,120,16,0,199
"Augusta County",-,"802 - Fishersville",154,167,27,0,348
"Augusta County",-,"803 - Wilson",86,101,13,0,200
"Augusta County",-,"Ab - Central Absentee Precinct",63,41,6,0,110
"Augusta County",-,Provisional,0,0,0,0,0
"Bath County",-,"101 - Warm Springs",22,14,2,0,38
"Bath County",-,"102 - Mountain Grove",12,8,2,0,22
"Bath County",-,"201 - Hot Springs",21,14,2,0,37
"Bath County",-,"301 - Fairview",17,22,0,0,39
"Bath County",-,"302 - Burnsville",5,2,1,0,8
"Bath County",-,"401 - Millboro",22,21,4,0,47
"Bath County",-,"501 - Healing Springs",23,22,2,0,47
"Bath County",-,"Ab - Central Absentee Precinct",7,1,1,0,9
"Bath County",-,Provisional,0,0,0,0,0
"Bedford County",-,"101 - Goodview Elem School (CD 5)",68,100,11,0,179
"Bedford County",-,"102 - Hardy Vol Fire Co (CD 5)",41,47,12,0,100
"Bedford County",-,"103 - Chamblissburg Baptist Church (CD 5)",45,78,8,0,131
"Bedford County",-,"104 - Stewartsville Rescue Squad (CD 5)",50,77,9,0,136
"Bedford County",-,"201 - Bedford Christian Church (CD 5)",23,61,5,0,89
"Bedford County",-,"202 - Staunton River High School (CD 5)",37,59,7,0,103
"Bedford County",-,"203 - Moneta Elem School (CD 5)",93,108,28,0,229
"Bedford County",-,"204 - Quaker Baptist Church (CD 5)",13,45,4,0,62
"Bedford County",-,"205 - Saunders Vol Fire Co (CD 5)",120,90,16,0,226
"Bedford County",-,"301 - New London Academy (CD 6)",315,299,45,0,659
"Bedford County",-,"302 - Bedford Regional Water Auth (CD 5)",111,108,19,0,238
"Bedford County",-,"303 - Bethesda United Methodist Church (CD 5)",71,88,20,0,179
"Bedford County",-,"304 - Forest Youth Athletic Assoc (CD 6)",59,75,17,0,151
"Bedford County",-,"305 - Huddleston Elem School (CD 5)",57,67,8,0,132
"Bedford County",-,"401 - Forest Elementary School (CD 6)",250,184,37,0,471
"Bedford County",-,"402 - Thomas Jefferson Elem School (CD 6)",83,104,27,0,214
"Bedford County",-,"403 - Knights Of Columbus Bldg (CD 6)",242,243,47,0,532
"Bedford County",-,"404 - St. Paul Baptist Church (CD 6)",241,184,54,0,479
"Bedford County",-,"502 - Big Island Elem School (CD 6)",23,22,2,0,47
"Bedford County",-,"503 - Sedalia Center (CD 6)",30,49,7,0,86
"Bedford County",-,"504 - Suck Springs Baptist Church (CD 6)",57,112,11,0,180
"Bedford County",-,"505 - Boonsboro Elementary School (CD 6)",110,128,31,0,269
"Bedford County",-,"506 - Boonsboro Ruritan Club (CD 6)",135,170,48,0,353
"Bedford County",-,"601 - Montvale Elem School (CD 6)",45,82,27,0,154
"Bedford County",-,"602 - Shady Grove Fire Department (CD 5)",40,93,13,0,146
"Bedford County",-,"603 - Thaxton Baptist Church #1 (CD 5)",13,24,1,0,38
"Bedford County",-,"604 - Bedford Welcome Center (CD 5)",63,99,18,0,180
"Bedford County",-,"701 - Goode Vol Rescue Squad (CD 5)",91,178,26,0,295
"Bedford County",-,"702 - Liberty High School (CD 5)",73,85,5,0,163
"Bedford County",-,"703 - Thaxton Baptist Church #2 (CD 5)",25,64,12,0,101
"Bedford County",-,"704 - Bedford Central Library (CD 5)",61,113,16,0,190
"Bedford County",-,"Ab - Central Absentee Precinct (CD 5)",41,32,9,0,82
"Bedford County",-,"Ab - Central Absentee Precinct (CD 6)",63,21,16,0,100
"Bedford County",-,"Provisional (CD 5)",0,0,0,0,0
"Bedford County",-,"Provisional (CD 6)",2,0,0,0,2
"Bland County",-,"101 - Bastian",10,31,1,0,42
"Bland County",-,"102 - Ceres",14,35,5,0,54
"Bland County",-,"201 - Davis",9,3,0,0,12
"Bland County",-,"202 - Seddon",40,37,13,0,90
"Bland County",-,"301 - Hollybrook",20,9,4,0,33
"Bland County",-,"302 - Mechanicsburg",12,5,0,0,17
"Bland County",-,"401 - Rocky Gap",35,63,3,0,101
"Bland County",-,"Ab - Central Absentee Precinct",6,4,0,0,10
"Bland County",-,Provisional,0,0,0,0,0
"Botetourt County",-,"101 - Daleville",100,74,20,0,194
"Botetourt County",-,"102 - Greenfield",106,147,38,0,291
"Botetourt County",-,"201 - Blue Ridge",88,127,14,0,229
"Botetourt County",-,"202 - Rainbow Forest",90,103,30,0,223
"Botetourt County",-,"301 - Buchanan",46,72,7,0,125
"Botetourt County",-,"302 - Mill Creek",87,83,13,0,183
"Botetourt County",-,"403 - Eagle Rock",38,53,10,0,101
"Botetourt County",-,"406 - Fincastle",97,125,14,0,236
"Botetourt County",-,"501 - Troutville",44,65,11,0,120
"Botetourt County",-,"502 - Cloverdale",117,146,29,0,292
"Botetourt County",-,"Ab - Central Absentee Precinct",46,15,4,0,65
"Botetourt County",-,Provisional,0,0,0,0,0
"Bristol City",-,"1 - First Ward",33,63,5,0,101
"Bristol City",-,"2 - Second Ward",49,86,8,0,143
"Bristol City",-,"3 - Third Ward",31,33,2,0,66
"Bristol City",-,"4 - Fourth Ward",50,164,5,0,219
"Bristol City",-,"Ab - Central Absentee Precinct",9,6,0,0,15
"Bristol City",-,Provisional,0,0,0,0,0
"Brunswick County",-,"101 - Brodnax",16,14,15,0,45
"Brunswick County",-,"102 - Rock Store",26,12,6,0,44
"Brunswick County",-,"103 - Tillman",34,43,10,0,87
"Brunswick County",-,"201 - Dromgoole",5,7,1,0,13
"Brunswick County",-,"202 - Edgerton",14,17,2,0,33
"Brunswick County",-,"203 - Fitzhugh",13,4,3,0,20
"Brunswick County",-,"301 - Alberta",6,11,1,0,18
"Brunswick County",-,"302 - Danieltown",24,29,2,0,55
"Brunswick County",-,"303 - Elmore",9,13,2,0,24
"Brunswick County",-,"304 - Seymour",5,3,7,0,15
"Brunswick County",-,"401 - Sturgeon",23,25,8,0,56
"Brunswick County",-,"402 - King's Store",8,2,1,0,11
"Brunswick County",-,"501 - Totaro",17,14,10,0,41
"Brunswick County",-,"Ab - Central Absentee Precinct",9,2,1,0,12
"Brunswick County",-,Provisional,0,0,0,0,0
"Buchanan County",-,"102 - Blackey",6,9,1,0,16
"Buchanan County",-,"103 - Hurley",30,22,1,0,53
"Buchanan County",-,"201 - Grassy",2,1,0,0,3
"Buchanan County",-,"202 - Bull",13,18,1,0,32
"Buchanan County",-,"203 - Rocklick",10,6,0,0,16
"Buchanan County",-,"301 - Slate",19,5,0,0,24
"Buchanan County",-,"302 - North Grundy",7,18,0,0,25
"Buchanan County",-,"403 - South Grundy",19,14,0,0,33
"Buchanan County",-,"404 - Oakwood",0,2,0,0,2
"Buchanan County",-,"501 - Prater",6,6,0,0,12
"Buchanan County",-,"502 - Fox",2,4,0,0,6
"Buchanan County",-,"503 - Vansant",4,8,0,0,12
"Buchanan County",-,"601 - Council",5,6,0,0,11
"Buchanan County",-,"602 - Garden",12,7,1,0,20
"Buchanan County",-,"603 - Hurricane",3,10,1,0,14
"Buchanan County",-,"701 - Whitewood",8,24,1,0,33
"Buchanan County",-,"702 - Contrary",6,15,0,0,21
"Buchanan County",-,"Ab - Central Absentee Precinct",23,9,1,0,33
"Buchanan County",-,Provisional,0,0,0,0,0
"Buckingham County",-,"101 - New Canton",61,57,4,0,122
"Buckingham County",-,"102 - Georgia Creek",3,29,2,0,34
"Buckingham County",-,"201 - White Hall",41,22,8,0,71
"Buckingham County",-,"301 - Curdsville",42,40,5,0,87
"Buckingham County",-,"302 - New Store",53,38,7,0,98
"Buckingham County",-,"401 - Maysville",53,65,9,0,127
"Buckingham County",-,"501 - Wrights",27,34,2,0,63
"Buckingham County",-,"502 - Glenmore",20,51,5,0,76
"Buckingham County",-,"601 - Slate River",21,50,4,0,75
"Buckingham County",-,"701 - Gold Hill",32,39,6,0,77
"Buckingham County",-,"Ab - Central Absentee Precinct",17,5,1,0,23
"Buckingham County",-,Provisional,0,0,0,0,0
"Buena Vista City",-,"1 - First Ward",70,43,18,0,131
"Buena Vista City",-,"2 - Second Ward",48,35,11,0,94
"Buena Vista City",-,Provisional,0,0,0,0,0
"Campbell County",-,"101 - Brookville",128,149,21,0,298
"Campbell County",-,"102 - New London",94,166,17,0,277
"Campbell County",-,"201 - Walker",81,99,9,0,189
"Campbell County",-,"202 - Bedford Springs",117,168,25,0,310
"Campbell County",-,"301 - Evington",30,48,6,0,84
"Campbell County",-,"302 - Otter River",23,52,3,0,78
"Campbell County",-,"303 - Altavista",74,96,17,0,187
"Campbell County",-,"401 - Three Forks",62,121,9,0,192
"Campbell County",-,"402 - Court House",95,183,26,0,304
"Campbell County",-,"501 - Spring Hill",95,149,15,0,259
"Campbell County",-,"502 - Yellow Branch",42,105,7,0,154
"Campbell County",-,"601 - Kings",60,85,13,0,158
"Campbell County",-,"602 - Concord",86,129,33,0,248
"Campbell County",-,"701 - Brookneal",38,67,6,0,111
"Campbell County",-,"702 - Gladys",48,101,15,0,164
"Campbell County",-,"703 - Morris Church",29,45,5,0,79
"Campbell County",-,"Ab - Central Absentee Precinct",47,15,8,0,70
"Campbell County",-,Provisional,0,0,0,0,0
"Caroline County",-,"101 - Bowling Green",111,56,7,0,174
"Caroline County",-,"102 - Sparta",59,44,5,0,108
"Caroline County",-,"201 - North Madison",24,56,6,0,86
"Caroline County",-,"202 - South Madison",56,43,9,0,108
"Caroline County",-,"301 - Port Royal",38,48,8,0,94
"Caroline County",-,"302 - Woodford",115,88,14,0,217
"Caroline County",-,"401 - Dawn",41,64,3,0,108
"Caroline County",-,"402 - Carmel Church",12,23,0,0,35
"Caroline County",-,"501 - West Mattaponi",37,37,2,0,76
"Caroline County",-,"502 - Milford",37,44,5,0,86
"Caroline County",-,"601 - Chilesburg",60,45,5,0,110
"Caroline County",-,"602 - Lake",35,47,7,0,89
"Caroline County",-,"Ab - Central Absentee Precinct",27,16,6,0,49
"Caroline County",-,Provisional,0,0,0,0,0
"Carroll County",-,"101 - Mt Bethel",27,39,6,0,72
"Carroll County",-,"102 - St Paul",49,99,17,1,166
"Carroll County",-,"103 - Lambsburg",49,63,7,0,119
"Carroll County",-,"105 - Fancy Gap",30,41,14,0,85
"Carroll County",-,"201 - Hillsville B",116,124,18,0,258
"Carroll County",-,"202 - Laurel Fork",43,23,10,0,76
"Carroll County",-,"203 - Gladesboro",50,41,12,0,103
"Carroll County",-,"301 - Hillsville C",84,64,4,0,152
"Carroll County",-,"302 - Sylvatus",25,30,8,0,63
"Carroll County",-,"303 - Dugspur",19,20,1,0,40
"Carroll County",-,"402 - Woodlawn D",29,80,16,0,125
"Carroll County",-,"403 - Oakland D",22,43,5,0,70
"Carroll County",-,"405 - Oakland A",19,23,2,0,44
"Carroll County",-,"406 - Woodlawn F",10,18,1,0,29
"Carroll County",-,"501 - Vaughan",18,31,2,0,51
"Carroll County",-,"502 - Gladeville",55,65,9,0,129
"Carroll County",-,"503 - Woodlawn E",28,29,5,0,62
"Carroll County",-,"504 - Laurel",32,32,2,0,66
"Carroll County",-,"Ab - Central Absentee Precinct",45,16,2,0,63
"Carroll County",-,Provisional,0,0,0,0,0
"Charles City County",-,"101 - Precinct 1-1",27,54,8,0,89
"Charles City County",-,"201 - Precinct 2-1",16,30,4,0,50
"Charles City County",-,"301 - Precinct 3-1",48,41,9,0,98
"Charles City County",-,"Ab - Central Absentee Precinct",8,4,1,0,13
"Charles City County",-,Provisional,0,0,0,0,0
"Charlotte County",-,"101 - County Seat",40,40,12,0,92
"Charlotte County",-,"201 - Red Oak Wylliesburg",37,52,4,0,93
"Charlotte County",-,"302 - Drakes Branch",25,22,1,0,48
"Charlotte County",-,"401 - Keysville",37,32,4,0,73
"Charlotte County",-,"501 - Cullen/Red House",30,32,5,0,67
"Charlotte County",-,"602 - Phenix",34,49,9,0,92
"Charlotte County",-,"702 - Bacon/Saxe",17,35,3,0,55
"Charlotte County",-,"Ab - Central Absentee Precinct",3,4,0,0,7
"Charlotte County",-,Provisional,1,0,0,0,1
"Charlottesville City",-,"101 - Recreation",33,28,9,0,70
"Charlottesville City",-,"102 - Clark",16,36,6,0,58
"Charlottesville City",-,"201 - Carver",15,13,2,0,30
"Charlottesville City",-,"202 - Walker",55,35,17,0,107
"Charlottesville City",-,"301 - Benjamin Tonsler",28,14,3,0,45
"Charlottesville City",-,"302 - Johnson",34,47,7,0,88
"Charlottesville City",-,"303 - Buford",5,12,2,0,19
"Charlottesville City",-,"401 - Venable",7,3,2,0,12
"Charlottesville City",-,"402 - Alumni Hall",35,15,6,0,56
"Charlottesville City",-,"Ab - Central Absentee Precinct",25,12,4,0,41
"Charlottesville City",-,Provisional,0,0,0,0,0
"Chesapeake City",-,"1 - Great Bridge (CD 4)",133,106,81,0,320
"Chesapeake City",-,"2 - Bethel (CD 4)",121,103,92,0,316
"Chesapeake City",-,"3 - Camelot (CD 3)",23,12,7,0,42
"Chesapeake City",-,"4 - Churchland (CD 3)",112,77,69,0,258
"Chesapeake City",-,"5 - Crestwood (CD 3)",9,10,11,0,30
"Chesapeake City",-,"6 - Deep Creek (CD 4)",109,99,76,0,284
"Chesapeake City",-,"7 - Greenbrier (CD 4)",136,94,82,0,312
"Chesapeake City",-,"8 - South Norfolk Recreation (CD 3)",74,74,59,0,207
"Chesapeake City",-,"9 - Bells Mill (CD 4)",210,158,114,0,482
"Chesapeake City",-,"10 - Oscar Smith (CD 3)",47,25,28,0,100
"Chesapeake City",-,"11 - Geneva Park (CD 3)",65,55,37,0,157
"Chesapeake City",-,"12 - Georgetown (CD 3)",21,14,13,0,48
"Chesapeake City",-,"13 - Gilmerton (CD 3)",67,65,41,0,173
"Chesapeake City",-,"14 - Grassfield (CD 4)",32,20,18,0,70
"Chesapeake City",-,"15 - B M Williams (CD 3)",36,47,24,0,107
"Chesapeake City",-,"16 - Hickory Grove (CD 4)",108,110,72,0,290
"Chesapeake City",-,"17 - Indian Creek (CD 4)",62,70,63,0,195
"Chesapeake City",-,"18 - Indian River (CD 3)",32,40,14,0,86
"Chesapeake City",-,"19 - Jolliff (CD 4)",99,72,64,0,235
"Chesapeake City",-,"20 - E W Chittum (CD 3)",1,0,0,0,1
"Chesapeake City",-,"20 - E W Chittum (CD 4)",116,88,88,0,292
"Chesapeake City",-,"21 - Fellowship (CD 3)",100,99,88,0,287
"Chesapeake City",-,"22 - Norfolk Highlands (CD 3)",46,50,47,0,143
"Chesapeake City",-,"23 - Oak Grove (CD 4)",80,49,37,0,166
"Chesapeake City",-,"24 - Oaklette (CD 3)",45,50,40,0,135
"Chesapeake City",-,"25 - St Julians (CD 3)",32,34,21,0,87
"Chesapeake City",-,"26 - Johnson Park (CD 3)",21,19,17,0,57
"Chesapeake City",-,"27 - Silverwood (CD 3)",145,94,109,0,348
"Chesapeake City",-,"28 - Sunray I (CD 4)",20,29,14,0,63
"Chesapeake City",-,"29 - Tanglewood (CD 3)",98,90,61,0,249
"Chesapeake City",-,"30 - South Norfolk (CD 3)",1,2,1,0,4
"Chesapeake City",-,"31 - Carver School (CD 3)",21,9,7,0,37
"Chesapeake City",-,"32 - Providence (CD 3)",6,4,6,0,16
"Chesapeake City",-,"33 - Westover (CD 3)",55,58,28,0,141
"Chesapeake City",-,"34 - Hickory Middle School (CD 4)",139,166,86,0,391
"Chesapeake City",-,"35 - Taylor Road (CD 3)",31,45,25,0,101
"Chesapeake City",-,"36 - Great Bridge Baptist Church (CD 4)",142,101,124,0,367
"Chesapeake City",-,"37 - Bridgetown (CD 4)",114,56,62,0,232
"Chesapeake City",-,"38 - Bailey Creek (CD 3)",113,107,78,0,298
"Chesapeake City",-,"39 - Lake Drummond (CD 4)",59,60,33,0,152
"Chesapeake City",-,"40 - River Birch (CD 3)",110,61,73,0,244
"Chesapeake City",-,"41 - John T West (CD 4)",77,112,66,0,255
"Chesapeake City",-,"42 - Parkways (CD 3)",60,40,40,0,140
"Chesapeake City",-,"43 - Pleasant Crossing (CD 4)",151,97,68,0,316
"Chesapeake City",-,"44 - Nansemond (CD 3)",63,38,53,0,154
"Chesapeake City",-,"45 - Sunray II (CD 4)",24,15,16,0,55
"Chesapeake City",-,"46 - Bells Mill II (CD 4)",82,46,60,0,188
"Chesapeake City",-,"47 - Green Sea (CD 4)",65,44,46,0,155
"Chesapeake City",-,"48 - Jolliff Middle School (CD 4)",21,16,8,0,45
"Chesapeake City",-,"49 - Waterway (CD 4)",159,191,134,0,484
"Chesapeake City",-,"50 - River Walk (CD 4)",71,55,66,0,192
"Chesapeake City",-,"51 - Coopers Way (CD 4)",132,144,109,0,385
"Chesapeake City",-,"52 - Shipyard Road (CD 4)",73,45,22,0,140
"Chesapeake City",-,"53 - Fairways (CD 3)",61,30,52,0,143
"Chesapeake City",-,"54 - Pughsville (CD 3)",32,45,34,0,111
"Chesapeake City",-,"55 - Georgetown East (CD 3)",32,23,22,0,77
"Chesapeake City",-,"56 - Green Tree (CD 3)",37,39,56,0,132
"Chesapeake City",-,"57 - Cypress (CD 3)",73,44,32,0,149
"Chesapeake City",-,"58 - Expressway (CD 4)",16,23,13,0,52
"Chesapeake City",-,"59 - Clearfield (CD 4)",64,39,53,0,156
"Chesapeake City",-,"60 - Parker Road (CD 4)",118,95,96,0,309
"Chesapeake City",-,"61 - Centerville (CD 4)",103,82,66,0,251
"Chesapeake City",-,"62 - Fentress (CD 4)",111,111,78,0,300
"Chesapeake City",-,"63 - Poplar Branch (CD 4)",84,55,52,0,191
"Chesapeake City",-,"AB - Central Absentee Precinct (CD 3)",50,29,15,0,94
"Chesapeake City",-,"Ab - Central Absentee Precinct (CD 4)",121,33,56,0,210
"Chesapeake City",-,"Provisional (CD 3)",0,1,1,0,2
"Chesapeake City",-,"Provisional (CD 4)",2,2,1,0,5
"Chesterfield County",-,"101 - Bellwood (CD 4)",48,60,17,0,125
"Chesterfield County",-,"102 - South Chester (CD 4)",96,105,28,0,229
"Chesterfield County",-,"103 - Enon (CD 4)",93,161,30,0,284
"Chesterfield County",-,"104 - North Chester (CD 4)",133,166,36,0,335
"Chesterfield County",-,"105 - Drewrys Bluff (CD 7)",56,73,13,0,142
"Chesterfield County",-,"106 - Harrowgate (CD 4)",132,163,21,0,316
"Chesterfield County",-,"107 - Wells (CD 4)",131,116,15,2,264
"Chesterfield County",-,"108 - Ecoff (CD 4)",257,226,49,0,532
"Chesterfield County",-,"109 - Elizabeth Scott (CD 4)",142,137,47,0,326
"Chesterfield County",-,"110 - Dutch Gap (CD 4)",58,65,24,0,147
"Chesterfield County",-,"111 - Iron Bridge (CD 4)",169,173,36,0,378
"Chesterfield County",-,"112 - Carver (CD 4)",105,82,22,0,209
"Chesterfield County",-,"201 - Gates (CD 4)",74,122,18,0,214
"Chesterfield County",-,"202 - Beulah (CD 7)",112,89,15,0,216
"Chesterfield County",-,"203 - Bird (CD 4)",18,30,2,0,50
"Chesterfield County",-,"204 - Jacobs (CD 7)",61,65,12,0,138
"Chesterfield County",-,"205 - Falling Creek (CD 7)",116,108,14,0,238
"Chesterfield County",-,"206 - Belmont (CD 7)",23,25,8,0,56
"Chesterfield County",-,"207 - Chippenham (CD 7)",18,18,8,0,44
"Chesterfield County",-,"208 - Meadowbrook (CD 7)",85,50,10,0,145
"Chesterfield County",-,"209 - Salem Church (CD 4)",104,140,21,0,265
"Chesterfield County",-,"210 - Five Forks (CD 7)",88,124,29,0,241
"Chesterfield County",-,"211 - Nash (CD 4)",250,192,37,0,479
"Chesterfield County",-,"212 - St. Luke's (CD 7)",84,89,27,0,200
"Chesterfield County",-,"213 - Southside (CD 7)",59,86,15,0,160
"Chesterfield County",-,"214 - Hopkins (CD 7)",1,2,2,0,5
"Chesterfield County",-,"215 - North Bird (CD 7)",20,23,6,0,49
"Chesterfield County",-,"301 - Ettrick (CD 4)",22,39,4,0,65
"Chesterfield County",-,"302 - Deer Run (CD 7)",63,48,14,0,125
"Chesterfield County",-,"303 - Matoaca (CD 4)",95,113,20,0,228
"Chesterfield County",-,"304 - Winfrees Store (CD 4)",174,213,27,0,414
"Chesterfield County",-,"305 - Beach (CD 4)",70,108,18,0,196
"Chesterfield County",-,"306 - Winterpock (CD 7)",186,240,30,0,456
"Chesterfield County",-,"307 - Cosby (CD 7)",112,117,19,0,248
"Chesterfield County",-,"308 - South Manchester (CD 7)",30,23,6,0,59
"Chesterfield County",-,"309 - Skinquarter (CD 7)",197,206,35,0,438
"Chesterfield County",-,"310 - Tomahawk (CD 7)",197,163,45,0,405
"Chesterfield County",-,"313 - Woolridge (CD 7)",174,148,52,0,374
"Chesterfield County",-,"315 - Bailey Bridge (CD 7)",173,187,36,0,396
"Chesterfield County",-,"316 - Spring Run (CD 7)",90,106,30,0,226
"Chesterfield County",-,"317 - Birkdale (CD 7)",195,153,41,0,389
"Chesterfield County",-,"318 - West Beach (CD 7)",41,58,7,0,106
"Chesterfield County",-,"401 - Harbour Pointe (CD 7)",107,79,24,0,210
"Chesterfield County",-,"402 - Genito (CD 7)",122,168,31,0,321
"Chesterfield County",-,"403 - Brandermill (CD 7)",136,109,51,0,296
"Chesterfield County",-,"404 - Providence (CD 7)",121,102,22,0,245
"Chesterfield County",-,"405 - La Prade (CD 7)",190,126,41,0,357
"Chesterfield County",-,"406 - Smoketree (CD 7)",204,110,32,0,346
"Chesterfield County",-,"407 - Monacan (CD 7)",96,79,31,0,206
"Chesterfield County",-,"408 - Reams (CD 7)",135,109,35,0,279
"Chesterfield County",-,"409 - Manchester (CD 7)",83,76,19,0,178
"Chesterfield County",-,"410 - Wagstaff (CD 7)",93,82,10,0,185
"Chesterfield County",-,"411 - Swift Creek (CD 7)",145,134,43,0,322
"Chesterfield County",-,"413 - Shenandoah (CD 7)",100,119,48,0,267
"Chesterfield County",-,"414 - Crenshaw (CD 7)",133,155,27,0,315
"Chesterfield County",-,"415 - Evergreen (CD 7)",124,112,29,0,265
"Chesterfield County",-,"416 - Evergreen West (CD 7)",48,41,11,0,100
"Chesterfield County",-,"417 - Edgewater (CD 7)",57,39,21,0,117
"Chesterfield County",-,"501 - Huguenot (CD 7)",120,77,32,0,229
"Chesterfield County",-,"502 - Crestwood (CD 7)",66,59,41,0,166
"Chesterfield County",-,"503 - Midlothian (CD 7)",176,130,37,1,344
"Chesterfield County",-,"504 - Robious (CD 7)",301,137,75,0,513
"Chesterfield County",-,"505 - Bon Air (CD 7)",166,127,94,0,387
"Chesterfield County",-,"506 - Greenfield (CD 7)",145,88,48,0,281
"Chesterfield County",-,"507 - Salisbury (CD 7)",309,137,108,0,554
"Chesterfield County",-,"508 - Belgrade (CD 7)",155,113,36,0,304
"Chesterfield County",-,"509 - Cranbeck (CD 7)",78,60,33,0,171
"Chesterfield County",-,"510 - Sycamore (CD 7)",188,99,42,0,329
"Chesterfield County",-,"511 - Black Heath (CD 7)",147,66,45,0,258
"Chesterfield County",-,"513 - Beaufont (CD 7)",31,24,8,0,63
"Chesterfield County",-,"514 - Watkins (CD 7)",223,143,52,0,418
"Chesterfield County",-,"515 - Davis (CD 7)",39,32,5,0,76
"Chesterfield County",-,"516 - Pocoshock (CD 7)",18,33,6,0,57
"Chesterfield County",-,"517 - Roseland (CD 7)",63,45,8,0,116
"Chesterfield County",-,"518 - Midlothian North (CD 7)",215,101,44,0,360
"Chesterfield County",-,"Ab - Central Absentee Precinct (CD 4)",84,44,6,0,134
"Chesterfield County",-,"Ab - Central Absentee Precinct (CD 7)",181,53,24,0,258
"Chesterfield County",-,"Provisional (CD 4)",0,0,0,0,0
"Chesterfield County",-,"Provisional (CD 7)",1,0,0,0,1
"Clarke County",-,"101 - Russell",112,101,14,0,227
"Clarke County",-,"201 - Berryville",71,73,20,0,164
"Clarke County",-,"301 - Millwood",61,63,19,0,143
"Clarke County",-,"302 - Pine Grove",26,46,5,0,77
"Clarke County",-,"401 - White Post",79,119,8,0,206
"Clarke County",-,"501 - Buckmarsh",42,80,10,0,132
"Clarke County",-,"502 - Blue Ridge",20,27,1,0,48
"Clarke County",-,"Ab - Central Absentee Precinct",18,10,3,0,31
"Clarke County",-,Provisional,0,0,0,0,0
"Colonial Heights City",-,"1 - First",59,72,5,0,136
"Colonial Heights City",-,"2 - Second",72,72,10,0,154
"Colonial Heights City",-,"3 - Third",139,106,15,0,260
"Colonial Heights City",-,"4 - Fourth",165,112,18,0,295
"Colonial Heights City",-,"5 - Fifth",249,100,25,0,374
"Colonial Heights City",-,"Ab - Central Absentee Precinct",49,15,1,0,65
"Colonial Heights City",-,Provisional,0,0,0,0,0
"Covington City",-,"101 - Precinct 1-1",6,10,1,0,17
"Covington City",-,"201 - Precinct 2-1",9,11,2,0,22
"Covington City",-,"301 - Precinct 3-1",2,6,2,0,10
"Covington City",-,"401 - Precinct 4-1",19,33,5,0,57
"Covington City",-,"501 - Precinct 5-1",19,20,3,0,42
"Covington City",-,"Ab - Central Absentee Precinct",3,1,1,0,5
"Covington City",-,Provisional,0,0,0,0,0
"Craig County",-,"101 - Court House",40,24,4,0,68
"Craig County",-,"201 - Ammendale Precinct",32,54,5,0,91
"Craig County",-,"301 - Givens & Reynolds Store",14,20,1,0,35
"Craig County",-,"303 - Marshalls Store",7,15,3,0,25
"Craig County",-,"401 - Barbours Creek",10,10,0,0,20
"Craig County",-,"402 - Paint Bank",3,4,0,0,7
"Craig County",-,"403 - Craig Springs",8,16,6,0,30
"Craig County",-,"501 - Craig City",25,31,5,0,61
"Craig County",-,Provisional,0,0,0,0,0
"Culpeper County",-,"101 - West Fairfax",104,151,25,0,280
"Culpeper County",-,"201 - East Fairfax",65,91,6,0,162
"Culpeper County",-,"302 - Eggbornsville",59,127,7,0,193
"Culpeper County",-,"303 - Cardova",33,126,10,0,169
"Culpeper County",-,"304 - Willow Shade",25,34,1,0,60
"Culpeper County",-,"401 - Eldorado",56,141,5,0,202
"Culpeper County",-,"402 - Browns Store",113,294,15,0,422
"Culpeper County",-,"501 - Jeffersonton",100,169,25,0,294
"Culpeper County",-,"502 - Rixeyville",66,199,27,0,292
"Culpeper County",-,"601 - Mitchells",20,23,8,0,51
"Culpeper County",-,"602 - Pearl Sample",99,186,15,0,300
"Culpeper County",-,"603 - South Ridge",24,38,13,0,75
"Culpeper County",-,"702 - Brandy Station",98,196,10,0,304
"Culpeper County",-,"703 - Lignum",26,94,11,0,131
"Culpeper County",-,"704 - Richardsville",33,62,5,0,100
"Culpeper County",-,"Ab - Central Absentee Precinct",43,41,7,0,91
"Culpeper County",-,Provisional,1,0,0,0,1
"Cumberland County",-,"101 - Precinct 1",92,53,9,0,154
"Cumberland County",-,"201 - Precinct 2",91,61,15,0,167
"Cumberland County",-,"301 - Precinct 3",36,22,5,0,63
"Cumberland County",-,"401 - Precinct 4",59,54,4,0,117
"Cumberland County",-,"501 - Precinct 5",73,32,5,0,110
"Cumberland County",-,"Ab - Central Absentee Precinct",7,7,7,0,21
"Cumberland County",-,Provisional,0,0,0,0,0
"Danville City",-,"1 - Ward One",6,2,1,0,9
"Danville City",-,"2 - Ward Two",20,16,2,0,38
"Danville City",-,"3 - Ward Three",38,28,10,0,76
"Danville City",-,"4 - Ward Four",92,84,13,0,189
"Danville City",-,"6 - Ward Six",7,5,1,0,13
"Danville City",-,"7 - Ward Seven",6,15,0,0,21
"Danville City",-,"8 - Ward Eight",12,36,6,0,54
"Danville City",-,"9 - Ward Nine",18,47,4,0,69
"Danville City",-,"10 - Ward Ten",35,58,13,0,106
"Danville City",-,"11 - Ward Eleven",44,39,7,0,90
"Danville City",-,"12 - Ward Twelve",49,67,15,0,131
"Danville City",-,"13 - Ward Thirteen",47,31,4,0,82
"Danville City",-,"14 - Ward Fourteen",0,0,0,0,0
"Danville City",-,"15 - Ward Fifteen",44,58,7,0,109
"Danville City",-,"16 - Ward Sixteen",57,102,8,0,167
"Danville City",-,"17 - Ward Seventeen",86,78,16,0,180
"Danville City",-,"Ab - Central Absentee Precinct",38,12,2,0,52
"Danville City",-,Provisional,0,0,0,0,0
"Dickenson County",-,"101 - South Clintwood",18,36,4,0,58
"Dickenson County",-,"201 - Nora",2,12,1,0,15
"Dickenson County",-,"202 - Frying Pan",3,12,0,0,15
"Dickenson County",-,"203 - Clinchco",6,16,1,0,23
"Dickenson County",-,"301 - West Dante",2,17,0,0,19
"Dickenson County",-,"302 - Herald",9,19,1,0,29
"Dickenson County",-,"303 - Ridge",10,10,1,0,21
"Dickenson County",-,"401 - Haysi-colley",9,19,3,0,31
"Dickenson County",-,"501 - Tarpon",10,6,0,0,16
"Dickenson County",-,"502 - North Clintwood",21,22,0,0,43
"Dickenson County",-,"Ab - Central Absentee Precinct",9,15,4,0,28
"Dickenson County",-,Provisional,0,0,0,0,0
"Dinwiddie County",-,"101 - White Oak",25,39,2,0,66
"Dinwiddie County",-,"102 - Rocky Run",33,62,7,0,102
"Dinwiddie County",-,"103 - Church Road",35,92,16,0,143
"Dinwiddie County",-,"201 - Rohoic",21,26,4,0,51
"Dinwiddie County",-,"202 - Sutherland",58,101,16,0,175
"Dinwiddie County",-,"301 - Reams",34,24,3,0,61
"Dinwiddie County",-,"302 - New Hope",41,51,9,0,101
"Dinwiddie County",-,"303 - Little Zion",25,45,4,0,74
"Dinwiddie County",-,"401 - Dinwiddie",48,76,12,0,136
"Dinwiddie County",-,"402 - Mckenney",29,36,3,0,68
"Dinwiddie County",-,"403 - Cherry Hill",14,25,1,0,40
"Dinwiddie County",-,"501 - Edgehill",6,3,0,0,9
"Dinwiddie County",-,"502 - Chesdin",20,50,5,0,75
"Dinwiddie County",-,"Ab - Central Absentee Precinct",20,5,2,0,27
"Dinwiddie County",-,Provisional,0,0,0,0,0
"Emporia City",-,"101 - Precinct 1-1",8,10,0,0,18
"Emporia City",-,"201 - Precinct 2-1",0,0,1,0,1
"Emporia City",-,"301 - Precinct 3-1",20,15,2,0,37
"Emporia City",-,"401 - Precinct 4-1",20,9,6,0,35
"Emporia City",-,"501 - Precinct 5-1",0,0,0,0,0
"Emporia City",-,"601 - District 6",28,14,5,0,47
"Emporia City",-,"701 - District 7",7,6,3,0,16
"Emporia City",-,Provisional,0,0,0,0,0
"Essex County",-,"101 - Greater Tappahannock",70,43,6,0,119
"Essex County",-,"201 - North",35,38,7,0,80
"Essex County",-,"301 - South",87,71,13,0,171
"Essex County",-,"401 - Central",60,45,12,0,117
"Essex County",-,"Ab - Central Absentee Precinct",10,3,1,0,14
"Essex County",-,Provisional,0,0,0,0,0
"Fairfax County",-,"104 - Chapel (CD 11)",86,97,29,0,212
"Fairfax County",-,"105 - Fairview (CD 11)",129,112,57,0,298
"Fairfax County",-,"106 - Heritage (CD 11)",35,55,11,0,101
"Fairfax County",-,"108 - Kings Park (CD 11)",49,127,25,0,201
"Fairfax County",-,"109 - Little Run (CD 11)",41,41,21,0,103
"Fairfax County",-,"110 - North Springfield (CD 11)",104,110,32,0,246
"Fairfax County",-,"113 - Canterbury (CD 11)",141,75,57,0,273
"Fairfax County",-,"114 - Olde Creek (CD 11)",56,71,22,0,149
"Fairfax County",-,"115 - Ravensworth (CD 11)",60,63,14,0,137
"Fairfax County",-,"116 - Wakefield (CD 11)",74,64,15,0,153
"Fairfax County",-,"117 - Woodson (CD 11)",76,52,21,0,149
"Fairfax County",-,"118 - Lake Braddock (CD 11)",60,73,28,0,161
"Fairfax County",-,"119 - Laurel (CD 11)",125,104,48,0,277
"Fairfax County",-,"120 - Sideburn (CD 11)",131,102,47,0,280
"Fairfax County",-,"121 - Villa (CD 11)",43,53,28,0,124
"Fairfax County",-,"123 - Robinson (CD 11)",104,98,40,0,242
"Fairfax County",-,"125 - Signal Hill (CD 11)",104,64,24,0,192
"Fairfax County",-,"126 - Bonnie Brae (CD 11)",69,52,23,0,144
"Fairfax County",-,"127 - Burke Centre (CD 11)",98,103,28,0,229
"Fairfax County",-,"128 - Cardinal (CD 11)",54,58,24,0,136
"Fairfax County",-,"129 - Keene Mill (CD 11)",59,42,12,0,113
"Fairfax County",-,"130 - Terra Centre (CD 11)",77,68,21,0,166
"Fairfax County",-,"131 - Eagle View (CD 11)",58,78,21,0,157
"Fairfax County",-,"132 - Monument (CD 11)",42,38,6,0,86
"Fairfax County",-,"133 - Danbury (CD 11)",10,15,4,0,29
"Fairfax County",-,"134 - University (CD 11)",10,7,3,0,20
"Fairfax County",-,"201 - Armstrong (CD 11)",76,56,25,0,157
"Fairfax County",-,"202 - Flint Hill (CD 11)",107,108,18,0,233
"Fairfax County",-,"203 - Floris (CD 11)",71,95,26,0,192
"Fairfax County",-,"204 - Madison (CD 11)",27,8,2,0,37
"Fairfax County",-,"208 - Reston #1 (CD 11)",37,43,21,0,101
"Fairfax County",-,"209 - Reston #2 (CD 11)",40,36,16,0,92
"Fairfax County",-,"213 - Vienna #1 (CD 11)",79,87,26,0,192
"Fairfax County",-,"214 - Vienna #2 (CD 11)",67,59,13,0,139
"Fairfax County",-,"216 - Vienna #4 (CD 11)",34,35,7,0,76
"Fairfax County",-,"218 - Vienna #6 (CD 11)",47,37,15,0,99
"Fairfax County",-,"219 - Westbriar (CD 11)",104,62,25,0,191
"Fairfax County",-,"220 - Dogwood (CD 11)",60,63,16,0,139
"Fairfax County",-,"221 - Hunters Woods (CD 11)",91,63,18,0,172
"Fairfax County",-,"222 - Reston #3 (CD 11)",33,19,10,0,62
"Fairfax County",-,"223 - Glade (CD 11)",66,60,30,0,156
"Fairfax County",-,"224 - South Lakes (CD 11)",64,68,23,0,155
"Fairfax County",-,"225 - Hughes (CD 11)",51,27,17,0,95
"Fairfax County",-,"226 - Wolftrap (CD 11)",107,99,26,0,232
"Fairfax County",-,"227 - Sunrise Valley (CD 11)",47,51,25,0,123
"Fairfax County",-,"229 - Fox Mill (CD 10)",151,144,46,0,341
"Fairfax County",-,"233 - North Point (CD 11)",86,46,20,0,152
"Fairfax County",-,"234 - Aldrin (CD 11)",54,68,19,0,141
"Fairfax County",-,"235 - Frying Pan (CD 11)",36,41,16,0,93
"Fairfax County",-,"236 - Stuart (CD 11)",22,27,10,0,59
"Fairfax County",-,"237 - Mcnair (CD 11)",18,21,11,0,50
"Fairfax County",-,"238 - Cameron Glen (CD 11)",63,48,18,0,129
"Fairfax County",-,"240 - Colvin (CD 10)",100,50,17,0,167
"Fairfax County",-,"301 - Chain Bridge (CD 10)",126,56,18,0,200
"Fairfax County",-,"302 - Chesterbrook (CD 8)",153,58,23,0,234
"Fairfax County",-,"303 - Churchill (CD 10)",52,29,7,0,88
"Fairfax County",-,"304 - Cooper (CD 10)",111,31,11,0,153
"Fairfax County",-,"305 - El Nido (CD 8)",83,29,11,0,123
"Fairfax County",-,"306 - Great Falls (CD 10)",102,54,23,0,179
"Fairfax County",-,"307 - Haycock (CD 8)",85,50,16,0,151
"Fairfax County",-,"309 - Kenmore (CD 10)",135,64,25,0,224
"Fairfax County",-,"310 - Kirby (CD 8)",69,41,10,0,120
"Fairfax County",-,"311 - Langley (CD 10)",142,45,10,0,197
"Fairfax County",-,"312 - Longfellow (CD 8)",69,35,15,0,119
"Fairfax County",-,"314 - Mclean (CD 10)",86,53,8,0,147
"Fairfax County",-,"315 - Pimmit (CD 8)",44,68,22,0,134
"Fairfax County",-,"316 - Salona #1 (CD 8)",40,20,10,0,70
"Fairfax County",-,"317 - Westhampton (CD 8)",63,72,25,0,160
"Fairfax County",-,"318 - Westmoreland (CD 8)",43,42,7,0,92
"Fairfax County",-,"319 - Herndon #1 (CD 11)",66,109,25,0,200
"Fairfax County",-,"320 - Herndon #2 (CD 11)",62,79,22,0,163
"Fairfax County",-,"321 - Clearview (CD 10)",108,115,49,0,272
"Fairfax County",-,"322 - Forestville (CD 10)",138,75,21,0,234
"Fairfax County",-,"323 - Shouse (CD 10)",90,53,28,0,171
"Fairfax County",-,"324 - Herndon #3 (CD 11)",45,71,23,0,139
"Fairfax County",-,"325 - Hutchison (CD 11)",13,30,2,0,45
"Fairfax County",-,"327 - Sugarland (CD 10)",93,77,30,0,200
"Fairfax County",-,"328 - Hickory (CD 10)",111,78,17,0,206
"Fairfax County",-,"329 - Seneca (CD 10)",118,89,22,0,229
"Fairfax County",-,"331 - Spring Hill (CD 10)",174,38,22,0,234
"Fairfax County",-,"332 - Coates (CD 11)",20,27,9,0,56
"Fairfax County",-,"333 - Salona #2 (CD 8)",75,50,19,0,144
"Fairfax County",-,"401 - Bush Hill (CD 8)",104,82,30,0,216
"Fairfax County",-,"402 - Cameron (CD 8)",16,19,6,0,41
"Fairfax County",-,"403 - Forestdale (CD 8)",14,30,6,0,50
"Fairfax County",-,"404 - Franconia (CD 8)",52,46,14,0,112
"Fairfax County",-,"405 - Groveton (CD 8)",17,23,8,0,48
"Fairfax County",-,"406 - Hayfield (CD 8)",93,80,25,0,198
"Fairfax County",-,"408 - Mount Eagle (CD 8)",44,33,13,0,90
"Fairfax County",-,"409 - Pioneer (CD 8)",42,70,10,0,122
"Fairfax County",-,"410 - Rose Hill (CD 8)",85,85,38,0,208
"Fairfax County",-,"411 - Virginia Hills (CD 8)",65,39,14,0,118
"Fairfax County",-,"413 - Fairfield (CD 8)",8,18,1,0,27
"Fairfax County",-,"415 - Crestwood (CD 8)",38,71,15,0,124
"Fairfax County",-,"417 - Garfield (CD 8)",44,57,14,0,115
"Fairfax County",-,"418 - Lynbrook (CD 8)",32,28,13,0,73
"Fairfax County",-,"419 - Lane (CD 8)",36,51,9,0,96
"Fairfax County",-,"420 - Villages (CD 8)",75,75,24,0,174
"Fairfax County",-,"421 - Kingstowne (CD 8)",60,38,13,0,111
"Fairfax County",-,"422 - Van Dorn (CD 8)",56,48,19,0,123
"Fairfax County",-,"423 - Clermont (CD 8)",67,62,14,0,143
"Fairfax County",-,"424 - Huntley (CD 8)",79,65,24,0,168
"Fairfax County",-,"426 - Greenspring (CD 11)",166,58,58,0,282
"Fairfax County",-,"427 - Island Creek (CD 8)",50,37,20,0,107
"Fairfax County",-,"428 - Pinewood (CD 8)",27,33,6,0,66
"Fairfax County",-,"429 - Hybla Valley (CD 8)",12,25,6,0,43
"Fairfax County",-,"501 - Baileys (CD 8)",45,35,15,0,95
"Fairfax County",-,"502 - Barcroft (CD 11)",31,35,16,0,82
"Fairfax County",-,"503 - Belvedere (CD 11)",35,41,6,0,82
"Fairfax County",-,"504 - Bristow (CD 11)",34,40,8,0,82
"Fairfax County",-,"505 - Glen Forest (CD 8)",28,33,11,0,72
"Fairfax County",-,"506 - Holmes #1 (CD 8)",2,5,0,0,7
"Fairfax County",-,"507 - Lincolnia (CD 8)",69,46,13,0,128
"Fairfax County",-,"508 - Masonville (CD 11)",52,60,9,0,121
"Fairfax County",-,"509 - Plaza (CD 8)",22,13,8,0,43
"Fairfax County",-,"510 - Parklawn (CD 8)",53,35,7,0,95
"Fairfax County",-,"511 - Ravenwood (CD 11)",66,40,28,0,134
"Fairfax County",-,"512 - Sleepy Hollow (CD 11)",41,23,13,0,77
"Fairfax County",-,"513 - Saint Albans (CD 11)",40,40,19,0,99
"Fairfax County",-,"513 - Saint Albans (CD 8)",25,23,8,0,56
"Fairfax County",-,"514 - Crossroads (CD 8)",25,6,3,0,34
"Fairfax County",-,"515 - Westlawn (CD 8)",31,19,8,0,58
"Fairfax County",-,"516 - Weyanoke (CD 8)",49,47,5,0,101
"Fairfax County",-,"517 - Willston (CD 8)",20,15,6,0,41
"Fairfax County",-,"518 - Columbia (CD 11)",58,44,9,0,111
"Fairfax County",-,"519 - Hummer (CD 11)",41,44,14,0,99
"Fairfax County",-,"520 - Skyline (CD 8)",38,14,5,0,57
"Fairfax County",-,"521 - Brook Hill (CD 8)",35,47,19,0,101
"Fairfax County",-,"522 - Camelot (CD 11)",62,50,19,0,131
"Fairfax County",-,"523 - Poe (CD 8)",42,36,17,0,95
"Fairfax County",-,"525 - Walnut Hill (CD 8)",71,47,16,0,134
"Fairfax County",-,"526 - Bren Mar (CD 8)",49,38,16,0,103
"Fairfax County",-,"527 - Edsall (CD 8)",40,40,14,0,94
"Fairfax County",-,"528 - Ridgelea (CD 11)",49,31,12,0,92
"Fairfax County",-,"530 - Holmes #2 (CD 11)",25,14,8,0,47
"Fairfax County",-,"601 - Belle Haven (CD 8)",101,47,17,0,165
"Fairfax County",-,"602 - Belleview (CD 8)",77,38,15,0,130
"Fairfax County",-,"604 - Bucknell (CD 8)",61,48,22,0,131
"Fairfax County",-,"605 - Fort Hunt (CD 8)",134,64,29,0,227
"Fairfax County",-,"606 - Hollin Hall (CD 8)",147,70,23,0,240
"Fairfax County",-,"607 - Huntington (CD 8)",112,47,16,0,175
"Fairfax County",-,"608 - Kirkside (CD 8)",71,29,7,0,107
"Fairfax County",-,"609 - Marlan (CD 8)",127,57,17,0,201
"Fairfax County",-,"610 - Sherwood (CD 8)",70,32,11,0,113
"Fairfax County",-,"611 - Stratford (CD 8)",170,65,39,0,274
"Fairfax County",-,"612 - Waynewood (CD 8)",76,45,15,0,136
"Fairfax County",-,"613 - Westgate (CD 8)",245,112,87,0,444
"Fairfax County",-,"614 - Riverside (CD 8)",134,62,45,0,241
"Fairfax County",-,"615 - Woodley (CD 8)",77,87,21,0,185
"Fairfax County",-,"616 - Gunston (CD 8)",82,106,20,0,208
"Fairfax County",-,"617 - Lorton (CD 8)",20,26,4,0,50
"Fairfax County",-,"618 - Newington (CD 11)",86,109,39,0,234
"Fairfax County",-,"619 - Belvoir (CD 8)",50,48,15,0,113
"Fairfax County",-,"621 - Grosvenor (CD 8)",26,31,14,0,71
"Fairfax County",-,"622 - Lorton Station (CD 8)",34,34,10,0,78
"Fairfax County",-,"623 - Alban (CD 8)",43,61,18,0,122
"Fairfax County",-,"625 - Lorton Center (CD 8)",52,31,13,0,96
"Fairfax County",-,"626 - Saratoga (CD 8)",76,87,24,0,187
"Fairfax County",-,"627 - Woodlawn (CD 8)",36,51,15,0,102
"Fairfax County",-,"628 - Laurel Hill (CD 11)",35,27,12,0,74
"Fairfax County",-,"629 - South County (CD 11)",74,100,31,0,205
"Fairfax County",-,"701 - Blake (CD 11)",77,77,23,0,177
"Fairfax County",-,"703 - Fort Buffalo (CD 8)",26,17,9,0,52
"Fairfax County",-,"704 - Freedom Hill (CD 11)",72,38,13,0,123
"Fairfax County",-,"705 - Graham - Greenway (CD 8)",56,49,21,0,126
"Fairfax County",-,"707 - Mantua (CD 11)",70,75,23,0,168
"Fairfax County",-,"708 - Marshall (CD 8)",72,64,23,0,159
"Fairfax County",-,"709 - Mosby (CD 11)",50,39,18,0,107
"Fairfax County",-,"710 - Pine Spring (CD 8)",29,40,9,0,78
"Fairfax County",-,"711 - Price (CD 11)",65,36,18,0,119
"Fairfax County",-,"712 - Shreve (CD 8)",55,30,15,0,100
"Fairfax County",-,"713 - Timber Lane (CD 8)",46,33,13,0,92
"Fairfax County",-,"714 - Walker (CD 11)",60,78,20,0,158
"Fairfax County",-,"717 - Woodburn (CD 11)",47,45,16,0,108
"Fairfax County",-,"718 - Pine Ridge (CD 11)",43,39,12,0,94
"Fairfax County",-,"720 - Thoreau (CD 11)",84,58,28,0,170
"Fairfax County",-,"721 - Merrifield (CD 11)",59,26,24,0,109
"Fairfax County",-,"726 - Magarity (CD 8)",47,67,18,0,132
"Fairfax County",-,"727 - Oakton (CD 11)",84,72,25,0,181
"Fairfax County",-,"729 - Nottoway (CD 11)",82,48,22,0,152
"Fairfax County",-,"730 - Penderbrook (CD 11)",75,68,15,0,158
"Fairfax County",-,"731 - Tysons (CD 11)",31,21,11,0,63
"Fairfax County",-,"732 - Oak Marr (CD 11)",117,76,24,0,217
"Fairfax County",-,"733 - Kilmer (CD 11)",62,51,8,0,121
"Fairfax County",-,"734 - Hunters Branch (CD 11)",42,12,13,0,67
"Fairfax County",-,"735 - Rotonda (CD 11)",28,34,9,0,71
"Fairfax County",-,"801 - Burke (CD 11)",86,100,27,0,213
"Fairfax County",-,"802 - Cedar Lake (CD 11)",21,23,0,0,44
"Fairfax County",-,"803 - Clifton (CD 10)",164,206,44,0,414
"Fairfax County",-,"804 - Colchester (CD 10)",76,69,26,0,171
"Fairfax County",-,"805 - Fairfax Station (CD 10)",75,84,22,0,181
"Fairfax County",-,"806 - Sydenstricker (CD 11)",101,92,29,0,222
"Fairfax County",-,"807 - Hunt Valley (CD 11)",76,68,31,0,175
"Fairfax County",-,"811 - Pohick (CD 11)",46,37,12,0,95
"Fairfax County",-,"812 - Valley (CD 11)",83,69,33,0,185
"Fairfax County",-,"815 - Woodyard (CD 10)",127,118,24,0,269
"Fairfax County",-,"824 - Orange (CD 11)",161,140,45,0,346
"Fairfax County",-,"825 - Cherry Run (CD 11)",90,91,22,0,203
"Fairfax County",-,"827 - Irving (CD 11)",81,74,28,0,183
"Fairfax County",-,"833 - White Oaks (CD 11)",66,96,22,0,184
"Fairfax County",-,"838 - Sangster (CD 10)",87,76,39,0,202
"Fairfax County",-,"839 - Silverbrook (CD 10)",113,128,48,0,289
"Fairfax County",-,"840 - West Springfield (CD 11)",97,71,26,0,194
"Fairfax County",-,"841 - Popes Head (CD 10)",76,73,22,0,171
"Fairfax County",-,"842 - Parkway (CD 11)",97,71,26,0,194
"Fairfax County",-,"843 - Fair Lakes (CD 11)",73,80,17,0,170
"Fairfax County",-,"844 - Centerpointe (CD 11)",27,40,12,0,79
"Fairfax County",-,"845 - Fountainhead (CD 10)",170,156,61,0,387
"Fairfax County",-,"846 - Greenbriar East (CD 11)",54,76,19,0,149
"Fairfax County",-,"847 - Greenbriar West (CD 10)",86,62,19,0,167
"Fairfax County",-,"848 - Fair Oaks (CD 11)",51,56,15,0,122
"Fairfax County",-,"849 - Newgate North (CD 10)",48,55,20,0,123
"Fairfax County",-,"850 - South Run (CD 10)",155,99,32,0,286
"Fairfax County",-,"851 - Willow Springs (CD 11)",81,78,14,0,173
"Fairfax County",-,"854 - Newgate South (CD 10)",146,96,20,0,262
"Fairfax County",-,"901 - Centre Ridge (CD 11)",46,41,15,0,102
"Fairfax County",-,"902 - Brookfield (CD 10)",78,95,27,0,200
"Fairfax County",-,"903 - Cub Run (CD 10)",102,101,42,0,245
"Fairfax County",-,"904 - Stonecroft (CD 10)",40,55,11,0,106
"Fairfax County",-,"905 - Franklin (CD 10)",34,45,10,0,89
"Fairfax County",-,"908 - Hidden Meadow (CD 10)",67,61,18,0,146
"Fairfax County",-,"909 - Oak Hill (CD 10)",75,50,24,0,149
"Fairfax County",-,"910 - London Towne (CD 11)",36,51,22,0,109
"Fairfax County",-,"911 - Navy (CD 10)",94,52,24,0,170
"Fairfax County",-,"913 - Rocky Run (CD 10)",111,98,28,0,237
"Fairfax County",-,"914 - Vale (CD 10)",94,57,18,0,169
"Fairfax County",-,"915 - Virginia Run (CD 10)",94,98,39,0,231
"Fairfax County",-,"916 - Waples Mill (CD 10)",174,125,33,0,332
"Fairfax County",-,"917 - Stone North (CD 10)",54,31,9,0,94
"Fairfax County",-,"918 - Centreville (CD 11)",59,59,18,0,136
"Fairfax County",-,"919 - Green Trails (CD 11)",49,73,17,0,139
"Fairfax County",-,"920 - Chantilly (CD 10)",79,44,23,0,146
"Fairfax County",-,"921 - Deer Park (CD 10)",99,122,23,0,244
"Fairfax County",-,"923 - Bull Run (CD 10)",82,83,16,0,181
"Fairfax County",-,"924 - Spindle (CD 11)",20,21,9,0,50
"Fairfax County",-,"925 - Old Mill (CD 10)",29,37,10,0,76
"Fairfax County",-,"926 - Powell (CD 11)",53,45,17,0,115
"Fairfax County",-,"927 - Armfield (CD 10)",31,37,12,0,80
"Fairfax County",-,"928 - Poplar Tree (CD 10)",88,60,22,0,170
"Fairfax County",-,"929 - Difficult Run (CD 10)",27,35,7,0,69
"Fairfax County",-,"930 - Lees Corner (CD 10)",84,57,22,0,163
"Fairfax County",-,"931 - Carson (CD 10)",35,51,18,0,104
"Fairfax County",-,"932 - Stone South (CD 10)",16,28,9,0,53
"Fairfax County",-,"933 - Compton (CD 11)",9,18,6,0,33
"Fairfax County",-,"Ab - Central Absentee Precinct (CD 10)",312,149,33,0,494
"Fairfax County",-,"Ab - Central Absentee Precinct (CD 11)",455,226,117,0,798
"Fairfax County",-,"Ab - Central Absentee Precinct (CD 8)",345,133,53,0,531
"Fairfax County",-,"Provisional (CD 10)",1,2,0,0,3
"Fairfax County",-,"Provisional (CD 11)",0,4,0,0,4
"Fairfax County",-,"Provisional (CD 8)",3,2,2,0,7
"Fairfax City",-,"1 - One",50,57,23,0,130
"Fairfax City",-,"2 - Two",94,61,34,0,189
"Fairfax City",-,"3 - Three",95,76,32,0,203
"Fairfax City",-,"4 - Four",69,84,30,0,183
"Fairfax City",-,"5 - Five",64,55,18,0,137
"Fairfax City",-,"6 - Six",62,70,12,0,144
"Fairfax City",-,"Ab - Central Absentee Precinct",33,15,7,0,55
"Fairfax City",-,Provisional,0,0,1,0,1
"Falls Church City",-,"1 - First Ward",81,31,18,0,130
"Falls Church City",-,"2 - Second Ward",77,21,12,0,110
"Falls Church City",-,"3 - Third Ward",80,46,12,0,138
"Falls Church City",-,"Ab - Central Absentee Precinct",16,7,3,0,26
"Falls Church City",-,Provisional,0,0,0,0,0
"Fauquier County",-,"101 - Kettle Run (CD 5)",50,80,19,0,149
"Fauquier County",-,"102 - Catlett (CD 1)",105,194,15,0,314
"Fauquier County",-,"103 - Casanova (CD 5)",45,90,15,0,150
"Fauquier County",-,"104 - Lois (CD 1)",57,111,8,0,176
"Fauquier County",-,"105 - Opal (CD 5)",43,84,13,0,140
"Fauquier County",-,"106 - Baldwin Ridge (CD 5)",62,77,16,0,155
"Fauquier County",-,"201 - Courthouse (CD 5)",127,113,27,0,267
"Fauquier County",-,"202 - Airlie (CD 5)",113,133,30,0,276
"Fauquier County",-,"203 - Warrenton (CD 5)",125,110,19,0,254
"Fauquier County",-,"301 - Morrisville (CD 1)",60,139,12,0,211
"Fauquier County",-,"302 - Remington (CD 5)",81,161,34,0,276
"Fauquier County",-,"303 - Bealeton (CD 1)",88,124,29,0,241
"Fauquier County",-,"401 - Marshall (CD 5)",119,151,34,0,304
"Fauquier County",-,"402 - Leeds (CD 5)",122,127,19,0,268
"Fauquier County",-,"403 - Waterloo (CD 5)",133,177,39,0,349
"Fauquier County",-,"404 - Springs Valley (CD 5)",66,86,26,0,178
"Fauquier County",-,"501 - The Plains (CD 5)",136,83,21,0,240
"Fauquier County",-,"502 - New Baltimore (CD 5)",83,145,41,0,269
"Fauquier County",-,"503 - Broad Run (CD 5)",132,140,37,0,309
"Fauquier County",-,"504 - Vint Hill (CD 5)",126,227,30,0,383
"Fauquier County",-,"Ab - Central Absentee Precinct (CD 1)",9,7,2,0,18
"Fauquier County",-,"Ab - Central Absentee Precinct (CD 5)",93,52,22,0,167
"Fauquier County",-,"Provisional (CD 1)",0,0,0,0,0
"Fauquier County",-,"Provisional (CD 5)",0,0,0,0,0
"Floyd County",-,"101 - Locust Grove",42,106,11,0,159
"Floyd County",-,"201 - Little River",35,78,18,0,131
"Floyd County",-,"301 - Courthouse",39,54,12,0,105
"Floyd County",-,"401 - Burks Fork",51,57,6,0,114
"Floyd County",-,"501 - Indian Valley",39,76,11,0,126
"Floyd County",-,"Ab - Central Absentee Precinct",21,9,3,0,33
"Floyd County",-,Provisional,0,0,0,0,0
"Fluvanna County",-,"101 - Palmyra",73,146,19,0,238
"Fluvanna County",-,"201 - Columbia",77,119,18,0,214
"Fluvanna County",-,"301 - Fork Union",75,132,19,0,226
"Fluvanna County",-,"401 - Cunningham",134,180,31,0,345
"Fluvanna County",-,"501 - Rivanna",170,176,61,0,407
"Fluvanna County",-,"Ab - Central Absentee Precinct",43,19,6,0,68
"Fluvanna County",-,Provisional,0,0,0,0,0
"Franklin County",-,"102 - Burnt Chimney",102,83,39,0,224
"Franklin County",-,"103 - Scruggs",288,190,56,0,534
"Franklin County",-,"201 - Glade Hill",50,70,14,0,134
"Franklin County",-,"202 - Penhook",83,78,31,0,192
"Franklin County",-,"203 - Hodgesville",4,8,1,0,13
"Franklin County",-,"204 - Dudley",59,42,13,0,114
"Franklin County",-,"301 - Snow Creek",18,39,12,0,69
"Franklin County",-,"302 - Fork Mountain",15,36,7,0,58
"Franklin County",-,"303 - Sontag",29,28,3,0,60
"Franklin County",-,"304 - Dickinson",18,23,2,0,43
"Franklin County",-,"401 - Henry",50,52,4,0,106
"Franklin County",-,"402 - Ferrum",33,42,9,0,84
"Franklin County",-,"403 - Endicott",37,33,3,0,73
"Franklin County",-,"501 - Waidsboro",30,53,6,0,89
"Franklin County",-,"502 - Callaway",55,77,8,0,140
"Franklin County",-,"503 - Bowmans",19,30,5,0,54
"Franklin County",-,"504 - Gogginsville",39,61,6,0,106
"Franklin County",-,"601 - Boones Mill",64,75,9,0,148
"Franklin County",-,"602 - Bonbrook",49,87,8,0,144
"Franklin County",-,"603 - Coopers Cove",49,90,17,0,156
"Franklin County",-,"701 - Rocky Mount East",70,71,11,0,152
"Franklin County",-,"702 - Rocky Mount West",44,40,15,0,99
"Franklin County",-,"703 - Rocky Mount South",33,41,5,0,79
"Franklin County",-,"Ab - Central Absentee Precinct",29,9,9,0,47
"Franklin County",-,Provisional,0,0,0,0,0
"Franklin City",-,"101 - Precinct 1-1",74,79,30,0,183
"Franklin City",-,"201 - Precinct 2-1",71,40,25,0,136
"Franklin City",-,"301 - Precinct 3-1",3,0,0,0,3
"Franklin City",-,"401 - Precinct 4-1",5,0,4,0,9
"Franklin City",-,"501 - Precinct 5-1",0,1,0,0,1
"Franklin City",-,"601 - Precinct 6-1",48,27,21,0,96
"Franklin City",-,"Ab - Central Absentee Precinct",15,3,4,0,22
"Franklin City",-,Provisional,0,0,0,0,0
"Frederick County",-,"101 - Russells",92,125,17,0,234
"Frederick County",-,"102 - Gore",69,107,9,0,185
"Frederick County",-,"103 - Kernstown",141,126,26,0,293
"Frederick County",-,"104 - Cedar Creek",46,83,7,0,136
"Frederick County",-,"201 - Gainesborough",54,109,8,0,171
"Frederick County",-,"202 - Albin",81,120,11,0,212
"Frederick County",-,"203 - Redland",72,122,24,0,218
"Frederick County",-,"204 - Nain",128,109,24,0,261
"Frederick County",-,"301 - Clear Brook",57,66,9,0,132
"Frederick County",-,"302 - Neff's Town",67,91,15,0,173
"Frederick County",-,"303 - White Hall",152,149,13,0,314
"Frederick County",-,"401 - Carpers Valley",128,117,27,0,272
"Frederick County",-,"402 - Shenandoah",52,58,6,0,116
"Frederick County",-,"403 - Parkin's Mill",70,82,18,0,170
"Frederick County",-,"404 - Armel",72,85,23,0,180
"Frederick County",-,"501 - Stephens City",99,99,20,0,218
"Frederick County",-,"502 - Newtown",114,85,22,0,221
"Frederick County",-,"503 - Canterburg",110,139,25,0,274
"Frederick County",-,"601 - Millbrook",65,52,16,0,133
"Frederick County",-,"602 - Ash Hollow",59,66,11,0,136
"Frederick County",-,"603 - Greenwood",105,154,24,0,283
"Frederick County",-,"Ab - Central Absentee Precinct",96,25,7,0,128
"Frederick County",-,Provisional,0,1,0,0,1
"Fredericksburg City",-,"101 - Precinct 1 - District One",143,92,32,0,267
"Fredericksburg City",-,"201 - Precinct 1 - District Two",167,80,46,0,293
"Fredericksburg City",-,"301 - Precinct 1 - District Three",140,85,20,0,245
"Fredericksburg City",-,"401 - Precinct 1 - District Four",64,33,11,0,108
"Fredericksburg City",-,"402 - Precinct 2 - District Four",36,20,15,0,71
"Fredericksburg City",-,"Ab - Central Absentee Precinct",30,11,3,0,44
"Fredericksburg City",-,Provisional,0,0,0,0,0
"Galax City",-,"1 - East",56,56,12,0,124
"Galax City",-,"2 - North",34,33,1,0,68
"Galax City",-,"3 - South",21,23,4,0,48
"Galax City",-,"Ab - Central Absentee Precinct",12,3,1,0,16
"Galax City",-,Provisional,0,0,0,0,0
"Giles County",-,"101 - Glen Lyn",4,9,0,0,13
"Giles County",-,"102 - Rich Creek",28,31,1,0,60
"Giles County",-,"103 - Narrows",54,63,11,0,128
"Giles County",-,"201 - Pearisburg",94,104,19,0,217
"Giles County",-,"202 - Staffordsville",20,14,1,0,35
"Giles County",-,"203 - White Gate",18,9,1,0,28
"Giles County",-,"301 - Eggleston",22,35,7,0,64
"Giles County",-,"302 - Pembroke",52,80,7,0,139
"Giles County",-,"303 - Newport",56,36,6,0,98
"Giles County",-,"Ab - Central Absentee Precinct",17,13,6,0,36
"Giles County",-,Provisional,0,0,0,0,0
"Gloucester County",-,"101 - Harcum",71,82,51,0,204
"Gloucester County",-,"102 - Salem",71,70,32,0,173
"Gloucester County",-,"103 - Peasley",45,58,29,0,132
"Gloucester County",-,"201 - Courthouse",98,90,36,0,224
"Gloucester County",-,"202 - Botetourt",109,119,53,0,281
"Gloucester County",-,"301 - White Marsh",71,107,52,0,230
"Gloucester County",-,"302 - Roanes",88,108,68,0,264
"Gloucester County",-,"401 - Hayes",94,97,45,0,236
"Gloucester County",-,"402 - Sarahs Creek",81,77,50,0,208
"Gloucester County",-,"501 - Achilles",157,161,88,0,406
"Gloucester County",-,"502 - Walker",102,104,58,0,264
"Gloucester County",-,"Ab - Central Absentee Precinct",31,17,14,0,62
"Gloucester County",-,Provisional,0,0,0,0,0
"Goochland County",-,"101 - Fife",70,57,7,0,134
"Goochland County",-,"102 - Hadensville",89,108,23,0,220
"Goochland County",-,"201 - Three Square",32,21,3,0,56
"Goochland County",-,"202 - Sandy Hook",124,124,20,0,268
"Goochland County",-,"301 - Goochland Court House 1",126,118,26,0,270
"Goochland County",-,"302 - Goochland Court House 2",66,28,10,0,104
"Goochland County",-,"401 - Shallow Well",122,93,19,0,234
"Goochland County",-,"402 - Centerville",297,200,28,0,525
"Goochland County",-,"501 - Manakin",304,119,60,0,483
"Goochland County",-,"502 - Blair Road",220,90,29,0,339
"Goochland County",-,"Ab - Central Absentee Precinct",80,22,8,0,110
"Goochland County",-,Provisional,0,0,0,0,0
"Grayson County",-,"101 - Bridle Creek",10,9,0,0,19
"Grayson County",-,"102 - Flatridge",4,6,0,0,10
"Grayson County",-,"103 - Grant",6,16,0,0,22
"Grayson County",-,"104 - Mouth Of Wilson",10,3,3,0,16
"Grayson County",-,"105 - Mount Rogers",3,13,0,0,16
"Grayson County",-,"106 - Rugby",5,9,3,0,17
"Grayson County",-,"107 - Troutdale",5,2,3,0,10
"Grayson County",-,"108 - Comers Rock",5,7,1,0,13
"Grayson County",-,"202 - Elk Creek",20,22,0,0,42
"Grayson County",-,"203 - Independence",39,69,11,0,119
"Grayson County",-,"301 - Baywood",23,40,3,0,66
"Grayson County",-,"302 - Fairview",24,46,3,0,73
"Grayson County",-,"401 - Fries",10,17,1,0,28
"Grayson County",-,"402 - Providence",22,45,5,0,72
"Grayson County",-,"403 - Oldtown",12,18,0,0,30
"Grayson County",-,"Ab - Central Absentee Precinct",6,10,3,0,19
"Grayson County",-,Provisional,0,0,0,0,0
"Greene County",-,"101 - Dyke",42,39,8,0,89
"Greene County",-,"102 - Swift Run",37,50,11,0,98
"Greene County",-,"201 - Ruckersville",81,98,26,0,205
"Greene County",-,"301 - Stanardsville",81,144,21,0,246
"Greene County",-,"401 - Midway",94,169,31,0,294
"Greene County",-,"Ab - Central Absentee Precinct",31,15,3,0,49
"Greene County",-,Provisional,0,0,0,0,0
"Greensville County",-,"101 - Precinct 1-a",8,8,3,0,19
"Greensville County",-,"102 - Precinct 1-b",13,8,1,0,22
"Greensville County",-,"103 - Precinct 1-c",5,5,1,0,11
"Greensville County",-,"201 - Precinct 2-a",27,6,1,0,34
"Greensville County",-,"202 - Precinct 2-b",31,30,2,0,63
"Greensville County",-,"302 - Precinct 3-a",35,15,3,0,53
"Greensville County",-,"401 - Precinct 4-a",22,5,2,0,29
"Greensville County",-,"402 - Precinct 4-b",18,14,4,0,36
"Greensville County",-,"403 - Precinct 4-c",10,11,2,0,23
"Greensville County",-,Provisional,0,0,0,0,0
"Halifax County",-,"101 - Childrey",20,40,7,0,67
"Halifax County",-,"102 - Liberty",19,23,2,0,44
"Halifax County",-,"103 - Republican Grove",28,34,4,0,66
"Halifax County",-,"201 - Clays Mill",23,35,1,0,59
"Halifax County",-,"202 - Crossroads",27,35,4,0,66
"Halifax County",-,"203 - Clover",15,34,1,0,50
"Halifax County",-,"302 - Meadville",8,10,3,0,21
"Halifax County",-,"304 - Vernon Hill",26,34,4,0,64
"Halifax County",-,"305 - Sinai",21,25,3,0,49
"Halifax County",-,"401 - Courthouse",37,42,5,0,84
"Halifax County",-,"403 - Center",76,54,4,0,134
"Halifax County",-,"502 - Dan River",74,74,4,0,152
"Halifax County",-,"503 - Scottsburg",35,48,13,0,96
"Halifax County",-,"601 - Black Walnut",22,38,0,0,60
"Halifax County",-,"603 - Mt Carmel",49,49,6,0,104
"Halifax County",-,"605 - Union",14,21,3,0,38
"Halifax County",-,"701 - Hyco",33,61,2,0,96
"Halifax County",-,"702 - Midway",32,70,1,0,103
"Halifax County",-,"703 - Virgilina",21,29,5,0,55
"Halifax County",-,"801 - South Boston",12,27,0,0,39
"Halifax County",-,"802 - South Boston West",19,7,2,0,28
"Halifax County",-,"Ab - Central Absentee Precinct",30,30,3,0,63
"Halifax County",-,Provisional,0,0,0,0,0
"Hampton City",-,"101 - Aberdeen (CD 3)",17,18,9,0,44
"Hampton City",-,"102 - Bassette (CD 3)",8,4,4,0,16
"Hampton City",-,"103 - City Hall (CD 3)",7,18,10,0,35
"Hampton City",-,"104 - Cooper (CD 3)",20,22,14,0,56
"Hampton City",-,"105 - East Hampton (CD 3)",33,17,17,0,67
"Hampton City",-,"106 - Armstrong (CD 3)",61,52,65,0,178
"Hampton City",-,"107 - Lindsay (CD 3)",31,23,10,0,64
"Hampton City",-,"108 - Thomas (CD 3)",23,22,14,0,59
"Hampton City",-,"109 - Phenix (CD 3)",11,8,4,0,23
"Hampton City",-,"110 - Phoebus (CD 2)",17,19,13,0,49
"Hampton City",-,"111 - Hampton Library (CD 3)",35,26,25,0,86
"Hampton City",-,"112 - Smith (CD 3)",53,46,27,0,126
"Hampton City",-,"115 - Wythe (CD 3)",52,45,50,0,147
"Hampton City",-,"116 - Jones (CD 3)",14,29,8,0,51
"Hampton City",-,"117 - Kecoughtan (CD 3)",31,32,12,0,75
"Hampton City",-,"118 - Mallory (CD 3)",19,20,14,0,53
"Hampton City",-,"201 - Booker (CD 2)",122,74,63,0,259
"Hampton City",-,"202 - Bryan (CD 2)",65,90,78,0,233
"Hampton City",-,"203 - Burbank (CD 2)",73,52,27,0,152
"Hampton City",-,"204 - Forrest (CD 3)",35,63,18,0,116
"Hampton City",-,"205 - Asbury (CD 2)",178,151,103,0,432
"Hampton City",-,"208 - Kraft (CD 3)",81,87,62,0,230
"Hampton City",-,"209 - Langley (CD 2)",43,57,28,0,128
"Hampton City",-,"210 - Machen (CD 3)",56,55,34,0,145
"Hampton City",-,"212 - Bethel (CD 3)",76,53,33,0,162
"Hampton City",-,"213 - Phillips (CD 2)",150,139,73,0,362
"Hampton City",-,"214 - Tucker Capps (CD 3)",77,63,34,0,174
"Hampton City",-,"215 - Tyler (CD 2)",0,0,0,0,0
"Hampton City",-,"215 - Tyler (CD 3)",6,10,4,0,20
"Hampton City",-,"216 - Sandy Bottom (CD 3)",29,31,26,0,86
"Hampton City",-,"217 - Syms (CD 3)",43,39,25,0,107
"Hampton City",-,"Ab - Central Absentee Precinct (CD 2)",10,5,6,0,21
"Hampton City",-,"Ab - Central Absentee Precinct (CD 3)",15,4,8,0,27
"Hampton City",-,"Provisional (CD 2)",0,0,0,0,0
"Hampton City",-,"Provisional (CD 3)",0,3,0,0,3
"Hanover County",-,"101 - Ashland",70,84,18,0,172
"Hanover County",-,"104 - Sliding Hill",104,95,28,0,227
"Hanover County",-,"105 - Berkley",60,37,10,0,107
"Hanover County",-,"106 - Kersey Creek",64,62,19,0,145
"Hanover County",-,"107 - Chickahominy",82,78,30,0,190
"Hanover County",-,"201 - Beaverdam",122,213,16,0,351
"Hanover County",-,"202 - Blunts",96,57,14,0,167
"Hanover County",-,"203 - Wilmington Parish",150,123,32,0,305
"Hanover County",-,"206 - Courthouse",86,66,24,0,176
"Hanover County",-,"208 - Oak Knoll",77,105,24,0,206
"Hanover County",-,"209 - West Hanover",27,33,5,0,65
"Hanover County",-,"210 - Oak Hill",45,43,9,0,97
"Hanover County",-,"301 - Clay",155,137,27,0,319
"Hanover County",-,"303 - Shady Grove",135,167,28,0,330
"Hanover County",-,"304 - Atlee",224,213,43,0,480
"Hanover County",-,"305 - Cool Spring",119,101,23,0,243
"Hanover County",-,"401 - Battlefield",116,222,25,0,363
"Hanover County",-,"403 - Cold Harbor",130,210,23,0,363
"Hanover County",-,"404 - Black Creek",132,299,25,0,456
"Hanover County",-,"405 - Pebble Creek",80,94,18,0,192
"Hanover County",-,"406 - Beaverdam Creek",20,37,4,0,61
"Hanover County",-,"502 - Rural Point",109,163,33,0,305
"Hanover County",-,"503 - Newman",78,89,9,0,176
"Hanover County",-,"504 - Studley",97,131,22,0,250
"Hanover County",-,"505 - Totopotomoy",62,135,10,0,207
"Hanover County",-,"506 - Georgetown",111,108,18,0,237
"Hanover County",-,"507 - Laurel Meadow",110,120,13,0,243
"Hanover County",-,"601 - Village",230,246,41,0,517
"Hanover County",-,"602 - Lee Davis",140,175,22,0,337
"Hanover County",-,"603 - Mechanicsville",63,84,14,0,161
"Hanover County",-,"604 - Hanover Grove",85,124,19,0,228
"Hanover County",-,"701 - Farrington",145,142,28,0,315
"Hanover County",-,"702 - Montpelier",103,112,23,0,238
"Hanover County",-,"703 - Rockville",144,120,25,0,289
"Hanover County",-,"704 - Elmont",128,138,21,1,288
"Hanover County",-,"705 - South Anna",81,72,17,0,170
"Hanover County",-,"Ab - Central Absentee Precinct",123,68,28,0,219
"Hanover County",-,Provisional,1,1,1,0,3
"Harrisonburg City",-,"101 - Northeast",37,81,10,0,128
"Harrisonburg City",-,"102 - East Central",50,25,4,0,79
"Harrisonburg City",-,"103 - Southeast",54,56,4,0,114
"Harrisonburg City",-,"104 - East",76,49,5,0,130
"Harrisonburg City",-,"105 - South East Central",14,2,1,0,17
"Harrisonburg City",-,"201 - Northwest",50,82,13,0,145
"Harrisonburg City",-,"202 - Southwest",58,76,9,0,143
"Harrisonburg City",-,"203 - West",59,79,6,0,144
"Harrisonburg City",-,"Ab - Central Absentee Precinct",33,14,3,0,50
"Harrisonburg City",-,Provisional,0,0,0,0,0
"Henrico County",-,"101 - Coalpit (CD 7)",154,107,28,0,289
"Henrico County",-,"102 - Dumbarton (CD 7)",95,57,14,0,166
"Henrico County",-,"103 - Glen Allen (CD 7)",323,175,55,0,553
"Henrico County",-,"104 - Glenside (CD 7)",34,31,10,0,75
"Henrico County",-,"105 - Greendale (CD 7)",130,95,22,0,247
"Henrico County",-,"106 - Hermitage (CD 7)",101,111,23,0,235
"Henrico County",-,"108 - Hungary Creek (CD 7)",270,157,46,0,473
"Henrico County",-,"109 - Hunton (CD 7)",84,62,18,0,164
"Henrico County",-,"110 - Johnson (CD 7)",38,30,6,0,74
"Henrico County",-,"111 - Lakeside (CD 7)",168,145,44,0,357
"Henrico County",-,"112 - Longan (CD 7)",188,104,29,0,321
"Henrico County",-,"113 - Maude Trevvett (CD 7)",102,53,33,0,188
"Henrico County",-,"114 - Monument Hills (CD 7)",64,40,10,0,114
"Henrico County",-,"115 - Staples Mill (CD 7)",316,192,44,0,552
"Henrico County",-,"117 - Westwood (CD 7)",122,58,24,0,204
"Henrico County",-,"201 - Adams (CD 4)",3,9,1,0,13
"Henrico County",-,"202 - Azalea (CD 7)",5,6,2,0,13
"Henrico County",-,"203 - Belmont (CD 7)",55,66,16,0,137
"Henrico County",-,"204 - Brookland (CD 7)",29,16,7,0,52
"Henrico County",-,"205 - Canterbury (CD 7)",168,25,19,0,212
"Henrico County",-,"206 - Central Gardens (CD 4)",1,3,2,0,6
"Henrico County",-,"207 - Chamberlayne (CD 7)",65,62,14,0,141
"Henrico County",-,"208 - Fairfield (CD 4)",7,4,0,0,11
"Henrico County",-,"209 - Glen Lea (CD 4)",10,22,3,0,35
"Henrico County",-,"210 - Greenwood (CD 7)",18,20,6,0,44
"Henrico County",-,"211 - Highland Gardens (CD 4)",2,3,0,0,5
"Henrico County",-,"212 - Hollybrook (CD 7)",14,30,6,0,50
"Henrico County",-,"213 - Hungary (CD 7)",26,15,8,0,49
"Henrico County",-,"214 - Longdale (CD 7)",38,46,13,0,97
"Henrico County",-,"215 - Maplewood (CD 4)",5,11,2,0,18
"Henrico County",-,"216 - Moody (CD 7)",52,52,11,0,115
"Henrico County",-,"217 - Mountain (CD 7)",36,31,4,0,71
"Henrico County",-,"218 - Oakview (CD 7)",6,4,0,0,10
"Henrico County",-,"219 - Randolph (CD 7)",4,10,2,0,16
"Henrico County",-,"220 - Ratcliffe (CD 4)",8,12,1,0,21
"Henrico County",-,"221 - Stratford Hall (CD 7)",12,15,1,0,28
"Henrico County",-,"222 - Wilder (CD 7)",31,32,0,0,63
"Henrico County",-,"223 - Yellow Tavern (CD 7)",99,87,21,0,207
"Henrico County",-,"224 - Essex Village (CD 4)",0,0,0,0,0
"Henrico County",-,"301 - Causeway (CD 7)",146,59,25,0,230
"Henrico County",-,"302 - Cedarfield (CD 7)",264,84,37,0,385
"Henrico County",-,"303 - Innsbrook (CD 7)",191,89,21,0,301
"Henrico County",-,"304 - Jackson Davis (CD 7)",96,70,20,0,186
"Henrico County",-,"305 - Nuckols Farm (CD 7)",263,135,58,0,456
"Henrico County",-,"306 - Pocahontas (CD 7)",148,47,18,0,213
"Henrico County",-,"307 - Ridge (CD 7)",96,59,30,0,185
"Henrico County",-,"308 - Rivers Edge (CD 7)",349,139,50,0,538
"Henrico County",-,"309 - Sadler (CD 7)",281,89,63,0,433
"Henrico County",-,"310 - Shady Grove (CD 7)",351,101,70,0,522
"Henrico County",-,"311 - Short Pump (CD 7)",251,108,59,0,418
"Henrico County",-,"312 - Springfield (CD 7)",64,34,15,0,113
"Henrico County",-,"313 - Stoney Run (CD 7)",229,110,38,0,377
"Henrico County",-,"314 - Three Chopt (CD 7)",130,110,30,0,270
"Henrico County",-,"315 - Tucker (CD 7)",53,37,13,0,103
"Henrico County",-,"401 - Quioccasin (CD 7)",146,85,21,0,252
"Henrico County",-,"402 - Crestview (CD 7)",78,61,11,0,150
"Henrico County",-,"403 - Derbyshire (CD 7)",201,63,39,0,303
"Henrico County",-,"404 - Freeman (CD 7)",85,45,19,0,149
"Henrico County",-,"405 - Gayton (CD 7)",327,131,38,0,496
"Henrico County",-,"406 - Godwin (CD 7)",181,79,31,0,291
"Henrico County",-,"407 - Lakewood (CD 7)",179,83,13,1,276
"Henrico County",-,"408 - Lauderdale (CD 7)",136,100,17,0,253
"Henrico County",-,"409 - Maybeury (CD 7)",189,86,61,0,336
"Henrico County",-,"410 - Mooreland (CD 7)",215,44,24,0,283
"Henrico County",-,"411 - Pemberton (CD 7)",115,48,26,0,189
"Henrico County",-,"412 - Pinchbeck (CD 7)",150,99,31,0,280
"Henrico County",-,"413 - Ridgefield (CD 7)",217,104,47,0,368
"Henrico County",-,"414 - Rollingwood (CD 7)",104,37,22,0,163
"Henrico County",-,"415 - Skipwith (CD 7)",65,56,10,0,131
"Henrico County",-,"416 - Spottswood (CD 7)",78,28,6,0,112
"Henrico County",-,"417 - Tuckahoe (CD 7)",340,84,59,0,483
"Henrico County",-,"418 - Welborne (CD 7)",100,32,24,0,156
"Henrico County",-,"419 - West End (CD 7)",202,94,44,0,340
"Henrico County",-,"501 - Antioch (CD 4)",88,133,21,1,243
"Henrico County",-,"502 - Cedar Fork (CD 4)",5,17,3,0,25
"Henrico County",-,"503 - Chickahominy (CD 4)",90,110,25,0,225
"Henrico County",-,"504 - Donahoe (CD 4)",28,41,3,0,72
"Henrico County",-,"505 - Dorey (CD 4)",72,108,18,0,198
"Henrico County",-,"506 - Eanes (CD 4)",21,28,7,0,56
"Henrico County",-,"507 - Elko (CD 4)",25,60,17,0,102
"Henrico County",-,"508 - Highland Springs (CD 4)",14,26,3,0,43
"Henrico County",-,"509 - Laburnum (CD 4)",37,37,5,0,79
"Henrico County",-,"510 - Mehfoud (CD 4)",18,44,14,0,76
"Henrico County",-,"511 - Montrose (CD 4)",26,24,9,0,59
"Henrico County",-,"512 - Nine Mile (CD 4)",27,38,2,0,67
"Henrico County",-,"513 - Pleasants (CD 4)",11,34,4,0,49
"Henrico County",-,"514 - Rolfe (CD 4)",21,23,5,0,49
"Henrico County",-,"515 - Sandston (CD 4)",57,140,16,0,213
"Henrico County",-,"516 - Sullivans (CD 4)",43,56,14,0,113
"Henrico County",-,"517 - Town Hall (CD 4)",33,47,9,0,89
"Henrico County",-,"518 - Whitlocks (CD 4)",48,96,31,0,175
"Henrico County",-,"AB - Central Absentee Precinct (CD 4)",44,7,2,0,53
"Henrico County",-,"Ab - Central Absentee Precinct (CD 7)",370,74,52,0,496
"Henrico County",-,"Provisional (CD 4)",0,1,0,0,1
"Henrico County",-,"Provisional (CD 7)",2,2,2,0,6
"Henry County",-,"101 - Bassett Number Two (CD 9)",17,11,0,0,28
"Henry County",-,"102 - Gunville (CD 9)",20,47,2,0,69
"Henry County",-,"103 - Scott's Tanyard (CD 9)",41,74,16,0,131
"Henry County",-,"201 - Fieldale (CD 9)",13,17,5,0,35
"Henry County",-,"202 - Horsepasture #1 (CD 9)",21,32,5,0,58
"Henry County",-,"203 - Horsepasture #2 (CD 9)",3,18,7,0,28
"Henry County",-,"204 - Spencer (CD 9)",21,40,13,0,74
"Henry County",-,"302 - Axton (CD 5)",17,28,2,0,47
"Henry County",-,"303 - Irisburg (CD 5)",26,38,10,0,74
"Henry County",-,"304 - Mount Olivet (CD 5)",44,42,11,0,97
"Henry County",-,"304 - Mount Olivet (CD 9)",0,0,0,0,0
"Henry County",-,"305 - Mountain Valley (CD 5)",16,30,4,0,50
"Henry County",-,"401 - Collinsville Number 1 (CD 9)",26,37,8,0,71
"Henry County",-,"402 - Daniels Creek (CD 9)",22,28,8,0,58
"Henry County",-,"404 - Collinsville Number 2 (CD 9)",58,59,9,1,127
"Henry County",-,"405 - Mountain View (CD 5)",18,29,6,0,53
"Henry County",-,"501 - Bassett Number One (CD 9)",20,21,4,0,45
"Henry County",-,"502 - Figsboro (CD 9)",28,41,12,0,81
"Henry County",-,"503 - Stanleytown (CD 9)",45,76,19,0,140
"Henry County",-,"504 - Oak Level (CD 9)",15,22,7,0,44
"Henry County",-,"505 - Dyers Store (CD 5)",0,4,1,0,5
"Henry County",-,"505 - Dyers Store (CD 9)",16,25,9,0,50
"Henry County",-,"601 - Fontaine (CD 9)",42,39,20,0,101
"Henry County",-,"602 - Hillcrest (CD 9)",13,11,6,0,30
"Henry County",-,"603 - Ridgeway #1 (CD 5)",40,61,7,0,108
"Henry County",-,"604 - Ridgeway #2 (CD 9)",44,37,12,0,93
"Henry County",-,"Ab - Central Absentee Precinct (CD 5)",10,7,2,0,19
"Henry County",-,"Ab - Central Absentee Precinct (CD 9)",27,17,5,0,49
"Henry County",-,"Provisional (CD 5)",0,0,0,0,0
"Henry County",-,"Provisional (CD 9)",0,1,0,0,1
"Highland County",-,"1 - Monterey",13,48,5,0,66
"Highland County",-,"3 - Wilsons Mill",1,10,2,0,13
"Highland County",-,"5 - Blue Grass",17,23,1,0,41
"Highland County",-,"7 - Mill Gap",8,13,3,0,24
"Highland County",-,"8 - Mcdowell",24,17,1,0,42
"Highland County",-,"10 - Headwaters",4,12,2,0,18
"Highland County",-,Provisional,0,0,0,0,0
"Hopewell City",-,"101 - Ward One",37,57,6,0,100
"Hopewell City",-,"201 - Ward Two",8,4,2,0,14
"Hopewell City",-,"301 - Ward Three",82,115,17,0,214
"Hopewell City",-,"401 - Ward Four",72,69,11,0,152
"Hopewell City",-,"501 - Ward Five",37,74,8,0,119
"Hopewell City",-,"601 - Ward Six",10,10,1,0,21
"Hopewell City",-,"701 - Ward Seven",20,41,8,0,69
"Hopewell City",-,"Ab - Central Absentee Precinct",11,15,5,0,31
"Hopewell City",-,Provisional,0,0,0,0,0
"Isle of Wight County",-,"101 - Smithfield",210,138,123,0,471
"Isle of Wight County",-,"102 - Cypress Creek",145,141,99,0,385
"Isle of Wight County",-,"201 - Bartlett",176,158,102,0,436
"Isle of Wight County",-,"202 - Carrollton",173,131,95,0,399
"Isle of Wight County",-,"301 - Rushmere",76,75,48,0,199
"Isle of Wight County",-,"302 - Pons",54,72,37,0,163
"Isle of Wight County",-,"401 - Courthouse",49,47,36,0,132
"Isle of Wight County",-,"402 - Windsor",138,102,66,0,306
"Isle of Wight County",-,"403 - Longview",66,86,40,0,192
"Isle of Wight County",-,"501 - Walters",102,89,48,0,239
"Isle of Wight County",-,"502 - Camps Mill",17,24,10,0,51
"Isle of Wight County",-,"503 - Carrsville",41,26,17,0,84
"Isle of Wight County",-,"504 - Zuni",88,80,61,0,229
"Isle of Wight County",-,"505 - Raynor",30,28,16,0,74
"Isle of Wight County",-,"Ab - Central Absentee Precinct",42,16,17,0,75
"Isle of Wight County",-,Provisional,2,1,3,0,6
"James City County",-,"101 - Berkeley A",162,115,85,0,362
"James City County",-,"102 - Berkeley B",76,92,39,0,207
"James City County",-,"103 - Berkeley C",362,165,117,0,644
"James City County",-,"104- Berkeley D",35,42,21,0,98
"James City County",-,"201 - Jamestown A",45,31,13,0,89
"James City County",-,"202 - Jamestown B",105,75,43,0,223
"James City County",-,"203 - Jamestown C",188,69,59,0,316
"James City County",-,"204 - Jamestown D",299,160,81,0,540
"James City County",-,"301 - Powhatan A",242,157,70,0,469
"James City County",-,"302 - Powhatan B",38,24,10,0,72
"James City County",-,"303 - Powhatan C",68,55,30,0,153
"James City County",-,"304 - Powhatan D",113,109,24,0,246
"James City County",-,"401 - Stonehouse A",122,127,47,0,296
"James City County",-,"402 - Stonehouse B",299,220,74,0,593
"James City County",-,"403 - Stonehouse C",148,130,65,0,343
"James City County",-,"501 - Roberts A",26,28,15,0,69
"James City County",-,"502 - Roberts B",314,134,82,0,530
"James City County",-,"503 - Roberts C",15,8,3,0,26
"James City County",-,"504 - Roberts D",197,122,67,0,386
"James City County",-,"Ab - Central Absentee Precinct",169,49,47,0,265
"James City County",-,Provisional,1,1,3,0,5
"King and Queen County",-,"101 - Owenton",14,19,0,0,33
"King and Queen County",-,"201 - Clarks",41,53,7,0,101
"King and Queen County",-,"301 - Shacklefords",42,18,17,0,77
"King and Queen County",-,"401 - Courthouse",31,44,7,0,82
"King and Queen County",-,"501 - Oldmill",55,33,9,0,97
"King and Queen County",-,"Ab - Central Absentee Precinct",13,5,0,0,18
"King and Queen County",-,Provisional,0,0,0,0,0
"King George County",-,"101 - Courthouse",75,117,17,0,209
"King George County",-,"102 - Passapatanzy",31,76,14,0,121
"King George County",-,"201 - Monroe",138,206,31,0,375
"King George County",-,"301 - Dahlgren",91,123,30,0,244
"King George County",-,"401 - Shiloh",118,189,36,0,343
"King George County",-,"Ab - Central Absentee Precinct",37,15,6,0,58
"King George County",-,Provisional,0,0,0,0,0
"King William County",-,"101 - West Point",90,75,38,0,203
"King William County",-,"201 - Sweet Hall",34,53,4,0,91
"King William County",-,"202 - Courthouse",51,57,5,0,113
"King William County",-,"301 - Aylett",73,125,18,0,216
"King William County",-,"401 - Manquin",72,114,15,0,201
"King William County",-,"501 - Mangohick",78,117,13,0,208
"King William County",-,"Ab - Central Absentee Precinct",14,3,4,0,21
"King William County",-,Provisional,0,0,0,0,0
"Lancaster County",-,"101 - Precinct 1-1",96,90,36,1,223
"Lancaster County",-,"201 - Precinct 2-1",54,29,14,0,97
"Lancaster County",-,"301 - Precinct 3-1",71,47,18,0,136
"Lancaster County",-,"302 - Precinct 3-2",43,28,8,0,79
"Lancaster County",-,"401 - Precinct 4-1",56,32,11,0,99
"Lancaster County",-,"501 - Precinct 5-1",143,66,37,0,246
"Lancaster County",-,"Ab - Central Absentee Precinct",38,11,7,0,56
"Lancaster County",-,Provisional,0,0,0,0,0
"Lee County",-,"101 - Elydale",2,19,2,0,23
"Lee County",-,"102 - Ewing",17,16,1,0,34
"Lee County",-,"103 - Rose Hill",3,29,0,0,32
"Lee County",-,"201 - Blackwater",3,5,0,0,8
"Lee County",-,"202 - Flatwoods",10,23,1,0,34
"Lee County",-,"203 - Jonesville",25,38,0,0,63
"Lee County",-,"301 - Ben Hur",14,44,2,0,60
"Lee County",-,"302 - Woodway",8,18,0,0,26
"Lee County",-,"401 - Stickleyville",4,11,0,0,15
"Lee County",-,"402 - Jasper",1,14,0,0,15
"Lee County",-,"403 - Seminary",7,26,1,0,34
"Lee County",-,"404 - Dryden",8,13,1,0,22
"Lee County",-,"501 - Saint Charles",4,5,0,0,9
"Lee County",-,"502 - Pennington",17,33,2,0,52
"Lee County",-,"503 - Robbins Chapel",3,6,0,0,9
"Lee County",-,"504 - Keokee",7,7,4,0,18
"Lee County",-,"Ab - Central Absentee Precinct",10,2,0,0,12
"Lee County",-,Provisional,0,0,0,0,0
"Lexington City",-,"1 - Lexington",98,60,10,0,168
"Lexington City",-,"Ab - Central Absentee Precinct",21,5,0,0,26
"Lexington City",-,Provisional,0,0,0,0,0
"Loudoun County",-,"107 - Little River",64,50,18,0,132
"Loudoun County",-,"108 - Mercer",51,54,11,0,116
"Loudoun County",-,"112 - Freedom",36,27,13,0,76
"Loudoun County",-,"114 - Dulles South",28,46,8,0,82
"Loudoun County",-,"117 - Carter",9,8,6,0,23
"Loudoun County",-,"118 - Moorefield",30,40,7,0,77
"Loudoun County",-,"119 - Arcola",54,62,16,0,132
"Loudoun County",-,"120 - Lunsford",48,28,11,0,87
"Loudoun County",-,"121 - Town Hall",58,51,9,0,118
"Loudoun County",-,"122 - Hutchison Farm",54,43,19,0,116
"Loudoun County",-,"123 - Cardinal Ridge",38,33,15,0,86
"Loudoun County",-,"124 - Liberty",31,24,7,0,62
"Loudoun County",-,"125 - Rock Ridge",21,16,5,0,42
"Loudoun County",-,"207 - River Bend",46,67,11,0,124
"Loudoun County",-,"208 - Algonkian",47,60,21,0,128
"Loudoun County",-,"209 - Potomac Falls",75,69,31,0,175
"Loudoun County",-,"210 - Cascades",49,56,15,0,120
"Loudoun County",-,"213 - Countryside",33,20,3,0,56
"Loudoun County",-,"214 - Sugarland North",171,61,37,0,269
"Loudoun County",-,"215 - Sugarland South",94,83,30,0,207
"Loudoun County",-,"216 - Lowes Island",84,53,6,0,143
"Loudoun County",-,"217 - South Bank",64,59,19,0,142
"Loudoun County",-,"218 - University Center",23,40,13,0,76
"Loudoun County",-,"219 - Galilee Church",29,67,8,0,104
"Loudoun County",-,"301 - Purcellville",120,88,32,0,240
"Loudoun County",-,"302 - Round Hill",109,126,12,0,247
"Loudoun County",-,"303 - Hillsboro",88,116,21,0,225
"Loudoun County",-,"305 - Philomont",45,69,13,0,127
"Loudoun County",-,"307 - Middleburg",60,42,9,0,111
"Loudoun County",-,"308 - St Louis",49,44,12,0,105
"Loudoun County",-,"309 - Aldie",75,44,7,0,126
"Loudoun County",-,"310 - Mountain View",92,89,18,0,199
"Loudoun County",-,"311 - Round Hill Elementary",83,82,33,0,198
"Loudoun County",-,"312 - Briar Woods",21,34,4,0,59
"Loudoun County",-,"313 - Pinebrook",94,104,13,0,211
"Loudoun County",-,"314 - Legacy",48,40,12,0,100
"Loudoun County",-,"315 - Firehouse",42,43,6,0,91
"Loudoun County",-,"316 - Creighton's Corner",48,58,17,0,123
"Loudoun County",-,"318 - Madison's Trust",47,68,7,0,122
"Loudoun County",-,"401 - West Lovettsville",98,146,24,0,268
"Loudoun County",-,"402 - Waterford",103,113,15,0,231
"Loudoun County",-,"403 - Lucketts",69,93,15,0,177
"Loudoun County",-,"407 - Harper Park",35,44,10,0,89
"Loudoun County",-,"408 - Evergreen",45,38,10,0,93
"Loudoun County",-,"409 - Clarkes Gap",101,128,30,0,259
"Loudoun County",-,"411 - East Lovettsville",70,112,22,0,204
"Loudoun County",-,"413 - Tuscarora",2,3,0,0,5
"Loudoun County",-,"414 - Red Rock",33,25,8,0,66
"Loudoun County",-,"416 - Hamilton",138,134,37,0,309
"Loudoun County",-,"419 - J. L. Simpson",65,93,16,0,174
"Loudoun County",-,"420 - River Creek",111,71,26,0,208
"Loudoun County",-,"421 - Between The Hills",10,18,6,0,34
"Loudoun County",-,"501 - West Leesburg",82,83,21,0,186
"Loudoun County",-,"502 - East Leesburg",27,46,17,0,90
"Loudoun County",-,"503 - Dry Mill",59,41,10,0,110
"Loudoun County",-,"504 - Smarts Mill",82,70,23,0,175
"Loudoun County",-,"505 - Cool Spring",86,81,21,0,188
"Loudoun County",-,"506 - Brandon Park",30,35,7,0,72
"Loudoun County",-,"507 - Greenway",49,29,14,0,92
"Loudoun County",-,"508 - Balls Bluff",58,49,18,0,125
"Loudoun County",-,"509 - Tolbert",27,43,6,0,76
"Loudoun County",-,"510 - Heritage",70,43,18,0,131
"Loudoun County",-,"615 - Hillside",57,61,27,0,145
"Loudoun County",-,"616 - Eagle Ridge",51,38,11,0,100
"Loudoun County",-,"617 - Oak Grove",12,11,3,0,26
"Loudoun County",-,"619 - Ridgetop",10,16,2,0,28
"Loudoun County",-,"620 - Russell Branch",76,74,25,0,175
"Loudoun County",-,"621 - Dominion Trail",69,60,20,0,149
"Loudoun County",-,"622 - Farmwell Station",67,71,18,0,156
"Loudoun County",-,"623 - Weller",99,78,17,0,194
"Loudoun County",-,"625 - Mill Run",33,28,5,0,66
"Loudoun County",-,"626 - Ashby Ponds",147,43,29,0,219
"Loudoun County",-,"627 - Ashbrook",40,31,6,0,77
"Loudoun County",-,"628 - Moorefield Station",21,28,10,0,59
"Loudoun County",-,"629 - Discovery",9,19,4,0,32
"Loudoun County",-,"701 - Sully",44,74,11,0,129
"Loudoun County",-,"702 - Park View",49,64,7,0,120
"Loudoun County",-,"703 - Rolling Ridge",20,45,8,0,73
"Loudoun County",-,"705 - Forest Grove",67,82,27,0,176
"Loudoun County",-,"707 - Claude Moore Park",25,21,3,0,49
"Loudoun County",-,"708 - Seneca",54,61,19,0,134
"Loudoun County",-,"709 - Mirror Ridge",35,47,18,0,100
"Loudoun County",-,"710 - Sterling",44,47,16,0,107
"Loudoun County",-,"808 - Stone Bridge",59,76,33,0,168
"Loudoun County",-,"810 - Cedar Lane",60,45,17,0,122
"Loudoun County",-,"813 - Seldens Landing",37,30,5,0,72
"Loudoun County",-,"814 - Newton - Lee",94,68,21,0,183
"Loudoun County",-,"815 - Belmont Ridge",105,79,20,0,204
"Loudoun County",-,"817 - Sanders Corner",91,75,39,0,205
"Loudoun County",-,"818 - Broad Run",41,37,20,0,98
"Loudoun County",-,"819 - Heritage Church",51,62,12,0,125
"Loudoun County",-,"820 - Belmont Station",45,44,18,0,107
"Loudoun County",-,"822 - Riverside",27,26,10,0,63
"Loudoun County",-,"Ab - Central Absentee Precinct",218,127,48,0,393
"Loudoun County",-,Provisional,1,2,0,0,3
"Louisa County",-,"101 - Zion",121,138,46,0,305
"Louisa County",-,"102 - Mechanicsville",59,72,19,0,150
"Louisa County",-,"201 - Louisa #1",137,98,40,0,275
"Louisa County",-,"202 - Louisa #2",78,88,42,0,208
"Louisa County",-,"301 - Patrick Henry No 1",121,89,33,0,243
"Louisa County",-,"302 - Patrick Henry #2",46,37,11,0,94
"Louisa County",-,"401 - Mineral",200,161,40,0,401
"Louisa County",-,"402 - Yanceyville",44,31,8,0,83
"Louisa County",-,"501 - Fredericks Hall",42,36,14,0,92
"Louisa County",-,"502 - Cuckoo",110,64,21,0,195
"Louisa County",-,"503 - Elk Creek",98,82,16,0,196
"Louisa County",-,"601 - Bumpass",91,99,31,0,221
"Louisa County",-,"602 - Locust Creek",145,126,26,0,297
"Louisa County",-,"701 - Sheltons Mill",119,110,28,0,257
"Louisa County",-,"702 - South Anna",111,65,27,0,203
"Louisa County",-,"Ab - Central Absentee Precinct",110,39,18,0,167
"Louisa County",-,Provisional,0,0,0,0,0
"Lunenburg County",-,"101 - Plymouth",32,32,5,0,69
"Lunenburg County",-,"201 - Browns Store",39,26,5,0,70
"Lunenburg County",-,"301 - Rosebud",21,23,2,0,46
"Lunenburg County",-,"302 - Flat Rock",21,23,2,0,46
"Lunenburg County",-,"401 - Arrowhead Gun Club",13,28,1,0,42
"Lunenburg County",-,"402 - Pleasant Grove",17,27,2,0,46
"Lunenburg County",-,"501 - Reedy Creek",18,15,1,0,34
"Lunenburg County",-,"502 - Peoples Community Center",10,13,0,0,23
"Lunenburg County",-,"601 - Hounds Creek",19,17,3,0,39
"Lunenburg County",-,"701 - Meherrin Fire Department",14,11,4,0,29
"Lunenburg County",-,"702 - Victoria Public Library",27,14,6,0,47
"Lunenburg County",-,"Ab - Central Absentee Precinct",11,2,2,0,15
"Lunenburg County",-,Provisional,0,0,0,0,0
"Lynchburg City",-,"101 - First Ward First Precinct",193,187,40,0,420
"Lynchburg City",-,"102 - First Ward Second Precinct",363,188,100,0,651
"Lynchburg City",-,"103 - First Ward Third Precinct",296,99,62,0,457
"Lynchburg City",-,"104 - First Ward Fourth Precinct",68,41,15,0,124
"Lynchburg City",-,"105 - First Ward Fifth Precinct",138,59,33,0,230
"Lynchburg City",-,"201 - Second Ward First Precinct",66,49,21,0,136
"Lynchburg City",-,"202 - Second Ward Second Precinct",48,19,12,0,79
"Lynchburg City",-,"203 - Second Ward Third Precinct",16,13,3,0,32
"Lynchburg City",-,"204 - Second Ward Fourth Precinct",39,38,8,0,85
"Lynchburg City",-,"301 - Third Ward First Precinct",61,58,9,0,128
"Lynchburg City",-,"302 - Third Ward Second Precinct",18,6,2,0,26
"Lynchburg City",-,"303 - Third Ward Third Precinct",119,63,16,0,198
"Lynchburg City",-,"304 - Third Ward Fourth Precinct",105,88,19,0,212
"Lynchburg City",-,"305 - Third Ward Fifth Precinct",244,177,46,0,467
"Lynchburg City",-,"401 - Fourth Ward First Precinct",332,256,54,0,642
"Lynchburg City",-,"402 - Fourth Ward Second Precinct",134,108,25,0,267
"Lynchburg City",-,"403 - Fourth Ward Third Precinct",204,133,36,0,373
"Lynchburg City",-,"404 - Fourth Ward Fourth Precinct",256,161,48,0,465
"Lynchburg City",-,"Ab - Central Absentee Precinct",130,45,21,0,196
"Lynchburg City",-,Provisional,4,0,0,0,4
"Madison County",-,"1 - Oak Park",27,47,5,0,79
"Madison County",-,"2 - Radiant",34,73,5,0,112
"Madison County",-,"3 - Rochelle",19,43,5,0,67
"Madison County",-,"4 - Graves Mill",4,13,3,0,20
"Madison County",-,"5 - Madison",49,95,11,0,155
"Madison County",-,"6 - Wolftown",35,33,5,0,73
"Madison County",-,"7 - Brightwood",53,96,19,0,168
"Madison County",-,"8 - Criglersville",36,33,7,0,76
"Madison County",-,"9 - Etlan",23,24,1,0,48
"Madison County",-,"Ab - Central Absentee Precinct",14,20,2,0,36
"Madison County",-,Provisional,0,0,0,0,0
"Manassas City",-,"1 - Dean",37,95,13,0,145
"Manassas City",-,"2 - Weems",79,161,30,0,270
"Manassas City",-,"3 - Metz",76,145,31,0,252
"Manassas City",-,"4 - Haydon",90,159,31,0,280
"Manassas City",-,"5 - Baldwin",56,109,20,0,185
"Manassas City",-,"6 - Round",110,156,43,0,309
"Manassas City",-,"Ab - Central Absentee Precinct",65,44,6,0,115
"Manassas City",-,Provisional,0,0,0,0,0
"Manassas Park City",-,"1 - Precinct One",18,50,14,0,82
"Manassas Park City",-,"2 - Precinct Two",16,86,10,0,112
"Manassas Park City",-,"3 - Precinct Three",29,53,15,0,97
"Manassas Park City",-,"Ab - Central Absentee Precinct",12,4,7,0,23
"Manassas Park City",-,Provisional,0,0,0,0,0
"Martinsville City",-,"1 - Precinct #1",0,4,1,0,5
"Martinsville City",-,"2 - Precinct #2",34,30,6,0,70
"Martinsville City",-,"3 - Precinct #3",15,13,4,0,32
"Martinsville City",-,"4 - Precinct #4",25,18,8,0,51
"Martinsville City",-,"5 - Precinct #5",90,59,25,0,174
"Martinsville City",-,"6 - Precinct #6",0,0,0,0,0
"Martinsville City",-,"Ab - Central Absentee Precinct",14,5,1,0,20
"Martinsville City",-,Provisional,0,0,0,0,0
"Mathews County",-,"1 - Chesapeake",75,71,30,0,176
"Mathews County",-,"2 - Westville",90,95,46,0,231
"Mathews County",-,"3 - Piankatank",89,103,47,0,239
"Mathews County",-,"Ab - Central Absentee Precinct",18,5,9,0,32
"Mathews County",-,Provisional,0,0,0,0,0
"Mecklenburg County",-,"101 - Wrights Store",12,20,6,0,38
"Mecklenburg County",-,"102 - Pearsons Store",10,20,4,0,34
"Mecklenburg County",-,"103 - South Clarksville",12,35,7,0,54
"Mecklenburg County",-,"201 - Boydton",8,13,4,0,25
"Mecklenburg County",-,"202 - Bluestone Senior High School",4,10,1,0,15
"Mecklenburg County",-,"203 - Chase City Vfw Post",5,14,2,0,21
"Mecklenburg County",-,"301 - Bracey",37,54,11,0,102
"Mecklenburg County",-,"302 - Lacrosse",15,16,8,0,39
"Mecklenburg County",-,"401 - American Legion Hall",14,23,2,0,39
"Mecklenburg County",-,"402 - Park View Middle School",7,2,0,0,9
"Mecklenburg County",-,"501 - South Hill",77,55,16,0,148
"Mecklenburg County",-,"601 - Baskerville",8,19,4,0,31
"Mecklenburg County",-,"602 - Union Level",18,13,5,0,36
"Mecklenburg County",-,"603 - Smith Crossroads",15,10,0,0,25
"Mecklenburg County",-,"604 - Lake Gaston",4,20,4,0,28
"Mecklenburg County",-,"701 - Chase City",37,36,6,0,79
"Mecklenburg County",-,"702 - Sunshine",17,26,1,0,44
"Mecklenburg County",-,"801 - Finchley",6,8,0,0,14
"Mecklenburg County",-,"802 - Bluestone",34,50,8,0,92
"Mecklenburg County",-,"803 - Chase City Elementary School",9,39,1,0,49
"Mecklenburg County",-,"901 - Averett",11,12,4,0,27
"Mecklenburg County",-,"902 - Buffalo Springs",14,25,3,0,42
"Mecklenburg County",-,"903 - Clarksville",71,73,18,0,162
"Mecklenburg County",-,"Ab - Central Absentee Precinct",11,4,6,0,21
"Mecklenburg County",-,Provisional,0,1,0,0,1
"Middlesex County",-,"101 - Saluda",28,8,3,0,39
"Middlesex County",-,"102 - Urbanna",66,40,16,0,122
"Middlesex County",-,"201 - New Market",104,112,38,0,254
"Middlesex County",-,"302 - Church View",42,35,17,0,94
"Middlesex County",-,"401- Harmony Village",59,54,12,0,125
"Middlesex County",-,"501 - Wilton",83,89,20,0,192
"Middlesex County",-,"Ab - Central Absentee Precinct",18,7,8,0,33
"Middlesex County",-,Provisional,0,0,0,0,0
"Montgomery County",-,"101 - Precinct A-1",85,72,15,0,172
"Montgomery County",-,"102 - Precinct A-2",39,21,10,0,70
"Montgomery County",-,"103 - Precinct A-3",72,50,24,0,146
"Montgomery County",-,"201 - Precinct B-1",4,5,2,0,11
"Montgomery County",-,"202 - Precinct B-2",70,59,14,0,143
"Montgomery County",-,"203 - Precinct B-3",53,39,11,0,103
"Montgomery County",-,"204 - Precinct B-4",81,78,19,0,178
"Montgomery County",-,"301 - Precinct C-1",44,71,6,0,121
"Montgomery County",-,"302 - Precinct C-2",57,79,21,0,157
"Montgomery County",-,"303 - Precinct C-3",35,38,2,0,75
"Montgomery County",-,"304 - Precinct C-4",37,54,13,0,104
"Montgomery County",-,"401 - Precinct D-1",38,41,13,0,92
"Montgomery County",-,"402 - Precinct D-2",53,73,11,0,137
"Montgomery County",-,"403 - Precinct D-3",40,44,4,0,88
"Montgomery County",-,"404 - Precinct D-4",20,50,8,0,78
"Montgomery County",-,"405 - Precinct D-5",48,63,6,0,117
"Montgomery County",-,"501 - Precinct E-1",57,46,14,0,117
"Montgomery County",-,"502 - Precinct E-2",33,39,12,0,84
"Montgomery County",-,"503 - Precinct E-3",1,0,1,0,2
"Montgomery County",-,"601 - Precinct F-1",46,34,12,0,92
"Montgomery County",-,"602 - Precinct F-2",37,23,9,0,69
"Montgomery County",-,"603 - Precinct F-3",1,0,2,0,3
"Montgomery County",-,"701 - Precinct G-1",80,40,22,0,142
"Montgomery County",-,"702 - Precinct G-2",21,15,12,0,48
"Montgomery County",-,"Ab - Central Absentee Precinct",48,18,15,0,81
"Montgomery County",-,Provisional,1,0,0,0,1
"Nelson County",-,"101 - Rockfish",52,86,14,0,152
"Nelson County",-,"201 - Lovingston",32,53,13,0,98
"Nelson County",-,"202 - Schuyler",12,36,4,0,52
"Nelson County",-,"301 - Shipman",20,57,8,0,85
"Nelson County",-,"302 - Gladstone",6,7,3,0,16
"Nelson County",-,"401 - Roseland",71,97,16,0,184
"Nelson County",-,"402 - Montebello",9,13,5,0,27
"Nelson County",-,"501 - Faber",13,41,3,0,57
"Nelson County",-,"502 - Nellysford",86,77,18,0,181
"Nelson County",-,"Ab - Central Absentee Precinct",9,3,2,0,14
"Nelson County",-,Provisional,0,2,0,0,2
"New Kent County",-,"102 - Tunstall",32,53,3,0,88
"New Kent County",-,"103 - Southern Branch",89,147,19,0,255
"New Kent County",-,"201 - Quinton",115,126,28,0,269
"New Kent County",-,"202 - Kentwood",69,86,15,0,170
"New Kent County",-,"301 - Watkins",54,68,6,0,128
"New Kent County",-,"302 - Cumberland",44,79,13,0,136
"New Kent County",-,"401 - Providence Forge",113,96,35,0,244
"New Kent County",-,"403 - Mountcastle",31,46,6,0,83
"New Kent County",-,"501 - Eltham",37,44,28,0,109
"New Kent County",-,"502 - Chickahominy River",70,94,40,0,204
"New Kent County",-,"Ab - Central Absentee Precinct",24,12,2,0,38
"New Kent County",-,Provisional,0,0,0,0,0
"Newport News City",-,"101 - Denbigh (CD 3)",39,44,24,0,107
"Newport News City",-,"102 - Epes (CD 3)",31,40,24,0,95
"Newport News City",-,"103 - Jenkins (CD 3)",64,53,39,0,156
"Newport News City",-,"104 - Mcintosh (CD 3)",23,23,16,0,62
"Newport News City",-,"105 - Oyster Point (CD 3)",32,13,9,0,54
"Newport News City",-,"106 - Reservoir (CD 3)",66,56,31,1,154
"Newport News City",-,"107 - Richneck (CD 3)",51,73,51,0,175
"Newport News City",-,"108 - Lee Hall (CD 3)",27,39,23,0,89
"Newport News City",-,"109 - Windsor (CD 3)",38,37,32,0,107
"Newport News City",-,"110 - Greenwood (CD 3)",27,27,20,0,74
"Newport News City",-,"201 - Bland (CD 3)",4,12,4,0,20
"Newport News City",-,"202 - Boulevard (CD 3)",95,66,42,0,203
"Newport News City",-,"203 - Charles (CD 3)",105,124,82,0,311
"Newport News City",-,"204 - Wellesley (CD 3)",49,29,36,0,114
"Newport News City",-,"205 - Deep Creek (CD 3)",115,105,116,0,336
"Newport News City",-,"208 - Hidenwood (CD 3)",90,46,123,0,259
"Newport News City",-,"209 - Hilton (CD 3)",94,54,68,0,216
"Newport News City",-,"210 - Nelson (CD 3)",124,106,102,0,332
"Newport News City",-,"211 - Palmer (CD 3)",55,44,41,0,140
"Newport News City",-,"212 - Riverside (CD 3)",78,40,107,0,225
"Newport News City",-,"213 - Sanford (CD 3)",58,42,46,0,146
"Newport News City",-,"215 - Warwick (CD 3)",43,40,35,0,118
"Newport News City",-,"216 - Yates (CD 3)",69,41,64,0,174
"Newport News City",-,"217 - Riverview (CD 3)",108,82,67,0,257
"Newport News City",-,"218 - Kiln Creek (CD 3)",133,96,82,0,311
"Newport News City",-,"219 - Deer Park (CD 3)",71,42,33,0,146
"Newport News City",-,"302 - Briarfield (CD 3)",16,13,10,0,39
"Newport News City",-,"303 - Carver (CD 3)",8,10,10,0,28
"Newport News City",-,"304 - Chestnut (CD 3)",0,0,3,0,3
"Newport News City",-,"305 - Downtown (CD 3)",0,8,5,0,13
"Newport News City",-,"306 - Dunbar (CD 3)",0,0,2,0,2
"Newport News City",-,"307 - Huntington (CD 3)",1,1,1,0,3
"Newport News City",-,"308 - Jefferson (CD 3)",2,0,0,0,2
"Newport News City",-,"309 - Magruder (CD 3)",2,0,0,0,2
"Newport News City",-,"310 - Marshall (CD 3)",0,1,1,0,2
"Newport News City",-,"311 - Newmarket (CD 3)",38,31,11,0,80
"Newport News City",-,"312 - Newsome Park (CD 3)",0,0,0,0,0
"Newport News City",-,"313 - Reed (CD 3)",2,2,2,0,6
"Newport News City",-,"314 - River (CD 3)",48,45,21,0,114
"Newport News City",-,"315 - Sedgefield (CD 3)",50,42,39,0,131
"Newport News City",-,"316 - South Morrison (CD 3)",52,45,22,0,119
"Newport News City",-,"317 - Washington (CD 3)",1,0,0,0,1
"Newport News City",-,"318 - Wilson (CD 3)",9,5,4,0,18
"Newport News City",-,"319 - Saunders (CD 3)",116,92,55,1,264
"Newport News City",-,"320 - Watkins (CD 3)",115,108,76,1,300
"Newport News City",-,"Ab - Central Absentee Precinct (CD 3)",50,20,25,0,95
"Newport News City",-,"Provisional (CD 3)",0,0,1,0,1
"Norfolk City",-,"101 - Granby (CD 2)",2,0,0,0,2
"Norfolk City",-,"101 - Granby (CD 3)",69,48,37,0,154
"Norfolk City",-,"102 - Ocean View School (CD 2)",39,30,24,0,93
"Norfolk City",-,"103 - Northside (CD 2)",71,51,48,0,170
"Norfolk City",-,"104 - Titustown (CD 2)",4,3,7,0,14
"Norfolk City",-,"104 - Titustown (CD 3)",0,0,0,0,0
"Norfolk City",-,"106 - Second Presbyterian (CD 2)",83,42,34,0,159
"Norfolk City",-,"201 - Larchmont School (CD 3)",103,51,66,0,220
"Norfolk City",-,"203 - Ghent Square (CD 3)",35,15,22,0,72
"Norfolk City",-,"207 - Lambert's Point (CD 3)",7,9,3,0,19
"Norfolk City",-,"208 - Larchmont Library (CD 3)",44,11,34,0,89
"Norfolk City",-,"210 - Maury (CD 3)",34,27,25,0,86
"Norfolk City",-,"211 - Chrysler Museum (CD 3)",85,33,72,0,190
"Norfolk City",-,"212 - Park Place (CD 3)",3,2,2,0,7
"Norfolk City",-,"213 - Taylor Elementary School (CD 3)",35,15,39,0,89
"Norfolk City",-,"214 - Stuart (CD 3)",40,29,22,0,91
"Norfolk City",-,"215 - Suburban Park (CD 2)",74,52,49,0,175
"Norfolk City",-,"217 - Wesley (CD 2)",30,30,16,0,76
"Norfolk City",-,"218 - Willard (CD 3)",76,56,71,0,203
"Norfolk City",-,"301 - Ballentine (CD 3)",9,8,9,0,26
"Norfolk City",-,"302 - Tanners Creek (CD 3)",9,7,7,0,23
"Norfolk City",-,"303 - Broad Creek (CD 3)",9,6,2,0,17
"Norfolk City",-,"304 - Coleman Place School (CD 3)",8,12,3,0,23
"Norfolk City",-,"305 - Lafayette-winona (CD 3)",17,15,8,0,40
"Norfolk City",-,"306 - Lindenwood (CD 3)",5,5,5,0,15
"Norfolk City",-,"309 - Norview (CD 3)",27,28,23,0,78
"Norfolk City",-,"310 - Rosemont (CD 3)",2,3,5,0,10
"Norfolk City",-,"311 - Sherwood (CD 3)",38,74,45,0,157
"Norfolk City",-,"313 - Union Chapel (CD 3)",0,5,3,0,8
"Norfolk City",-,"402 - Berkley (CD 3)",0,0,2,0,2
"Norfolk City",-,"403 - Brambleton (CD 3)",0,2,2,0,4
"Norfolk City",-,"404 - Campostella (CD 3)",2,3,1,0,6
"Norfolk City",-,"405 - Chesterfield (CD 3)",1,3,1,0,5
"Norfolk City",-,"406 - Barron Black (CD 2)",36,40,19,0,95
"Norfolk City",-,"408 - Easton (CD 3)",50,59,44,0,153
"Norfolk City",-,"409 - Fairlawn (CD 3)",43,50,14,0,107
"Norfolk City",-,"411 - Ruffner Academy (CD 3)",0,0,0,0,0
"Norfolk City",-,"412 - Ingleside (CD 3)",20,11,17,0,48
"Norfolk City",-,"413 - Poplar Halls (CD 3)",21,28,25,0,74
"Norfolk City",-,"414 - Young Park (CD 3)",0,0,0,0,0
"Norfolk City",-,"415 - Lake Taylor High School (CD 3)",18,27,19,0,64
"Norfolk City",-,"501 - Bayview (CD 2)",67,90,56,0,213
"Norfolk City",-,"503 - East Ocean View (CD 2)",72,60,64,0,196
"Norfolk City",-,"504 - Larrymore (CD 2)",59,53,26,0,138
"Norfolk City",-,"505 - Little Creek (CD 2)",41,40,35,0,116
"Norfolk City",-,"506 - Ocean View Center (CD 2)",48,60,23,0,131
"Norfolk City",-,"507 - Pretlow (CD 2)",78,68,35,0,181
"Norfolk City",-,"509 - Tarrallton (CD 2)",98,76,56,0,230
"Norfolk City",-,"510 - Third Presbyterian (CD 2)",85,87,91,0,263
"Norfolk City",-,"511 - Crossroads (CD 2)",62,65,59,0,186
"Norfolk City",-,"512 - Azalea Gardens (CD 2)",56,31,45,0,132
"Norfolk City",-,"Ab - Central Absentee Precinct (CD 2)",24,10,11,0,45
"Norfolk City",-,"Ab - Central Absentee Precinct (CD 3)",24,6,12,0,42
"Norfolk City",-,"Provisional (CD 2)",0,0,0,0,0
"Norfolk City",-,"Provisional (CD 3)",1,0,0,0,1
"Northampton County",-,"101 - Precinct 1-1",59,54,36,0,149
"Northampton County",-,"201 - Precinct 2-1",19,13,12,0,44
"Northampton County",-,"301 - Precinct 3-1",36,18,9,0,63
"Northampton County",-,"401 - Precinct 4-1",56,33,16,0,105
"Northampton County",-,"501 - Precinct 5-1",70,58,20,0,148
"Northampton County",-,"Ab - Central Absentee Precinct",17,3,6,0,26
"Northampton County",-,Provisional,0,0,0,0,0
"Northumberland County",-,"101 - 1a",98,69,10,0,177
"Northumberland County",-,"201 - 2a",125,90,17,0,232
"Northumberland County",-,"301 - 3a",25,34,6,0,65
"Northumberland County",-,"302 - 3b",7,2,3,0,12
"Northumberland County",-,"401 - 4a",190,116,46,0,352
"Northumberland County",-,"501 - 5a",187,136,31,0,354
"Northumberland County",-,"Ab - Central Absentee Precinct",22,14,3,0,39
"Northumberland County",-,Provisional,0,1,0,0,1
"Norton City",-,"1 - East Ward",33,50,3,0,86
"Norton City",-,Provisional,0,0,0,0,0
"Nottoway County",-,"101 - Precinct 1-1",31,22,4,0,57
"Nottoway County",-,"102 - Precinct 1-2",16,32,2,0,50
"Nottoway County",-,"201 - Precinct 2-1",57,58,10,0,125
"Nottoway County",-,"202 - Precinct 2-2",23,23,3,0,49
"Nottoway County",-,"301 - Precinct 3-1",12,13,3,0,28
"Nottoway County",-,"302 - Precinct 3-2",22,14,2,0,38
"Nottoway County",-,"401 - Precinct 4-1",10,6,1,0,17
"Nottoway County",-,"402 - Precinct 4-2",46,35,4,0,85
"Nottoway County",-,"501 - Precinct 5-1",65,42,16,0,123
"Nottoway County",-,"Ab - Central Absentee Precinct",16,3,0,0,19
"Nottoway County",-,Provisional,0,0,0,0,0
"Orange County",-,"101 - One West",70,136,25,0,231
"Orange County",-,"102 - One East",74,92,16,0,182
"Orange County",-,"201 - Two West",62,109,9,0,180
"Orange County",-,"202 - Two East",63,108,11,0,182
"Orange County",-,"301 - Three West",95,86,7,0,188
"Orange County",-,"302 - Three East",24,49,2,0,75
"Orange County",-,"401 - Four West",93,132,11,0,236
"Orange County",-,"402 - Four East",70,96,8,0,174
"Orange County",-,"501 - Five South",152,120,20,0,292
"Orange County",-,"502 - Five North",249,142,31,0,422
"Orange County",-,"Ab - Central Absentee Precinct",34,24,6,0,64
"Orange County",-,Provisional,0,0,0,0,0
"Page County",-,"101 - West Luray",101,93,11,0,205
"Page County",-,"201 - East Luray",107,152,10,0,269
"Page County",-,"301 - Marksville",78,132,13,0,223
"Page County",-,"401 - Newport",63,67,5,0,135
"Page County",-,"501 - Shenandoah",57,155,9,0,221
"Page County",-,"Ab - Central Absentee Precinct",24,13,2,0,39
"Page County",-,Provisional,0,0,0,0,0
"Patrick County",-,"101 - Ararat",3,12,7,0,22
"Patrick County",-,"102 - Claudville",11,40,10,0,61
"Patrick County",-,"103 - Willis Gap",8,36,7,0,51
"Patrick County",-,"201 - Dry Pond",8,9,4,0,21
"Patrick County",-,"202 - Patrick Springs",15,32,5,0,52
"Patrick County",-,"203 - Russell Creek",8,24,2,0,34
"Patrick County",-,"301 - Critz/stella",17,49,8,0,74
"Patrick County",-,"302 - Liberty",14,35,3,0,52
"Patrick County",-,"401 - Meadows Of Dan",8,41,8,0,57
"Patrick County",-,"402 - Stuart Administration",10,45,8,0,63
"Patrick County",-,"501 - Stuart Community",8,18,3,0,29
"Patrick County",-,"502 - Elamsville",17,39,6,0,62
"Patrick County",-,"503 - Woolwine",23,35,9,0,67
"Patrick County",-,"Ab - Central Absentee Precinct",11,8,0,0,19
"Patrick County",-,Provisional,0,0,0,0,0
"Petersburg City",-,"101 - First Ward First Precinct",16,9,3,0,28
"Petersburg City",-,"201 - Second Ward First Precinct",9,12,1,0,22
"Petersburg City",-,"301 - Third Ward First Precinct",18,17,5,0,40
"Petersburg City",-,"401 - Fourth Ward First Precinct",8,14,10,0,32
"Petersburg City",-,"501 - Fifth Ward First Precinct",5,13,2,0,20
"Petersburg City",-,"601 - Sixth Ward First Precinct",1,0,0,0,1
"Petersburg City",-,"701 - Seventh Ward First Precinct",9,11,4,0,24
"Petersburg City",-,"Ab - Central Absentee Precinct",27,8,6,0,41
"Petersburg City",-,Provisional,0,0,0,0,0
"Pittsylvania County",-,"103 - Twin Springs",101,129,18,0,248
"Pittsylvania County",-,"105 - Chatham",51,40,9,0,100
"Pittsylvania County",-,"106 - Tunstall",31,48,5,0,84
"Pittsylvania County",-,"108 - West Blairs",25,43,8,0,76
"Pittsylvania County",-,"201 - Callands",40,55,7,0,102
"Pittsylvania County",-,"202- Bearskin",10,14,2,0,26
"Pittsylvania County",-,"204 - Sandy Level",30,64,5,0,99
"Pittsylvania County",-,"206 - Climax",37,34,5,0,76
"Pittsylvania County",-,"207 - Gretna",71,99,9,0,179
"Pittsylvania County",-,"301 - Central",15,21,5,0,41
"Pittsylvania County",-,"305 - Riceville",10,31,2,0,43
"Pittsylvania County",-,"307 - East Blairs",11,10,1,0,22
"Pittsylvania County",-,"308 - Mt Airy",7,15,2,0,24
"Pittsylvania County",-,"309 - East Gretna",23,15,3,0,41
"Pittsylvania County",-,"402 - Keeling",45,64,7,0,116
"Pittsylvania County",-,"404 - Kentuck",61,105,11,0,177
"Pittsylvania County",-,"405 - Ringgold",67,145,14,0,226
"Pittsylvania County",-,"501 - Hurt",69,85,14,0,168
"Pittsylvania County",-,"502 - Motley Sycamore",58,94,11,0,163
"Pittsylvania County",-,"503 - Renan",32,60,2,0,94
"Pittsylvania County",-,"603 - Stony Mill",40,62,6,0,108
"Pittsylvania County",-,"604 - Swansonville",28,40,4,0,72
"Pittsylvania County",-,"605 - Whitmell",28,53,4,0,85
"Pittsylvania County",-,"606 - Brosville",22,25,4,0,51
"Pittsylvania County",-,"607 - Dry Fork",38,18,7,0,63
"Pittsylvania County",-,"702 - Bachelors Hall",49,105,13,0,167
"Pittsylvania County",-,"703 - Ferry Road",11,15,1,0,27
"Pittsylvania County",-,"704 - Mt Hermon",106,110,10,0,226
"Pittsylvania County",-,"705 - Mt Cross",41,63,2,0,106
"Pittsylvania County",-,"Ab - Central Absentee Precinct",48,18,3,0,69
"Pittsylvania County",-,Provisional,0,0,0,0,0
"Poquoson City",-,"1 - Central",136,107,71,0,314
"Poquoson City",-,"2 - Eastern",106,120,88,0,314
"Poquoson City",-,"3 - Western",195,123,112,0,430
"Poquoson City",-,"Ab - Central Absentee Precinct",19,6,8,0,33
"Poquoson City",-,Provisional,0,1,0,0,1
"Portsmouth City",-,"1 - Emanuel A. M. E. Church",44,39,27,0,110
"Portsmouth City",-,"5 - Hampton Roads Community Health Center",2,2,1,0,5
"Portsmouth City",-,"7- Park View Elementary School",10,16,12,0,38
"Portsmouth City",-,"9 - Third Baptist Church",6,14,16,0,36
"Portsmouth City",-,"10 - Port Norfolk Recreation Center",13,26,18,0,57
"Portsmouth City",-,"11 - Mt. Hermon Village",2,1,1,0,4
"Portsmouth City",-,"13 - St. Mark Missionary Baptist Church",1,0,1,0,2
"Portsmouth City",-,"14 - Emily N. Spong Preschool",2,3,0,0,5
"Portsmouth City",-,"16 - Cradock Middle School",28,29,21,0,78
"Portsmouth City",-,"17 - Victory Life Fellowship",31,24,10,0,65
"Portsmouth City",-,"19 - Fairview Heights Baptist Church",18,23,11,0,52
"Portsmouth City",-,"20 - Noble Street Baptist Church",14,12,11,0,37
"Portsmouth City",-,"21 - John F. Kennedy Community Center",1,3,1,0,5
"Portsmouth City",-,"22 - Forward Church",33,27,18,0,78
"Portsmouth City",-,"23 - Westhaven Baptist Church",41,64,25,0,130
"Portsmouth City",-,"24 - Willett Hall",18,20,22,0,60
"Portsmouth City",-,"25 - John Tyler Elementary School",48,37,15,0,100
"Portsmouth City",-,"26 - William E. Waters Middle School",1,1,1,0,3
"Portsmouth City",-,"27 - Cavalier Manor Recreation Center",1,3,2,0,6
"Portsmouth City",-,"28 - Lakeview Elementary School",3,2,3,0,8
"Portsmouth City",-,"29 - Saint Andrew's United Methodist Church",58,50,21,0,129
"Portsmouth City",-,"30 - The Rescue Church",36,64,22,0,122
"Portsmouth City",-,"31 - West Park Church Of Christ",42,38,22,0,102
"Portsmouth City",-,"32 - Hodges Manor Elementary School",84,45,30,0,159
"Portsmouth City",-,"33- Pinecrest Baptist Church",64,54,34,0,152
"Portsmouth City",-,"34- Churchland Branch Library",64,40,50,0,154
"Portsmouth City",-,"35 - Churchland Elementary School",69,73,29,0,171
"Portsmouth City",-,"36 - Scottish Rite Temple",106,133,73,0,312
"Portsmouth City",-,"37 - Churchland Middle School",50,47,31,0,128
"Portsmouth City",-,"38 - Grove Baptist Church",13,20,7,0,40
"Portsmouth City",-,"39 - River Shore Baptist Church",62,49,37,0,148
"Portsmouth City",-,"Ab - Central Absentee Precinct",11,9,8,0,28
"Portsmouth City",-,Provisional,0,0,0,0,0
"Powhatan County",-,"101 - Subletts",138,106,33,0,277
"Powhatan County",-,"102 - Manakin",99,91,42,0,232
"Powhatan County",-,"103 - Flat Rock",64,73,24,0,161
"Powhatan County",-,"201 - Powhatan Station",113,89,23,0,225
"Powhatan County",-,"202 - Graceland",108,99,42,0,249
"Powhatan County",-,"301 - Bethesda",91,96,38,0,225
"Powhatan County",-,"302 - Lee's Landing",68,67,23,0,158
"Powhatan County",-,"401 - Powhatan Courthouse",178,165,45,0,388
"Powhatan County",-,"402 - Mt Zion",52,54,12,0,118
"Powhatan County",-,"501 - Smith Cross Roads",69,61,9,0,139
"Powhatan County",-,"502 - Pineville",38,41,15,0,94
"Powhatan County",-,"503 - Tobaccoville",41,30,9,0,80
"Powhatan County",-,"Ab - Central Absentee Precinct",41,18,8,0,67
"Powhatan County",-,Provisional,0,0,0,0,0
"Prince Edward County",-,"101 - Farmville",73,35,7,0,115
"Prince Edward County",-,"201 - Lockett",84,46,8,0,138
"Prince Edward County",-,"301 - Leigh",33,24,5,0,62
"Prince Edward County",-,"302 - Mt Pleasant",12,13,6,0,31
"Prince Edward County",-,"401 - Hampden",32,22,10,0,64
"Prince Edward County",-,"501 - Darlington Hts",44,39,1,0,84
"Prince Edward County",-,"502 - Buffalo Hts",33,15,4,0,52
"Prince Edward County",-,"601 - Prospect",69,33,6,0,108
"Prince Edward County",-,"701 - West End",70,30,9,0,109
"Prince Edward County",-,"801 - Center",14,5,0,0,19
"Prince Edward County",-,"Ab - Central Absentee Precinct",23,6,4,0,33
"Prince Edward County",-,Provisional,0,0,0,0,0
"Prince George County",-,"101 - Richard Bland (CD 4)",83,66,14,0,163
"Prince George County",-,"102 - Templeton (CD 4)",130,235,21,0,386
"Prince George County",-,"103 - Union Branch (CD 4)",77,109,23,0,209
"Prince George County",-,"104 - Rives (CD 4)",26,44,6,0,76
"Prince George County",-,"105 - Harrison (CD 4)",28,48,15,0,91
"Prince George County",-,"201 - Bland (CD 4)",153,169,40,0,362
"Prince George County",-,"202 - Black Water (CD 4)",106,127,25,0,258
"Prince George County",-,"203 - Brandon (CD 4)",47,37,13,0,97
"Prince George County",-,"204 - Courts Bldg (CD 4)",75,99,28,0,202
"Prince George County",-,"205 - Jefferson Park (CD 4)",21,39,10,0,70
"Prince George County",-,"Ab - Central Absentee Precinct (CD 4)",34,20,8,0,62
"Prince George County",-,"Provisional (CD 4)",0,0,0,0,0
"Prince William County",-,"101 - Brentsville (CD 1)",85,205,21,0,311
"Prince William County",-,"102 - Cedar Point (CD 1)",121,144,33,0,298
"Prince William County",-,"103 - Glenkirk (CD 1)",82,142,17,0,241
"Prince William County",-,"104 - Nokesville (CD 1)",109,165,19,0,293
"Prince William County",-,"105 - Limestone (CD 1)",101,138,16,0,255
"Prince William County",-,"106 - Westgate (CD 1)",15,64,10,0,89
"Prince William County",-,"107 - Marsteller (CD 1)",115,170,25,0,310
"Prince William County",-,"108 - Victory (CD 1)",92,120,23,0,235
"Prince William County",-,"109 - Piney Branch (CD 1)",62,82,17,0,161
"Prince William County",-,"110 - Buckland Mills (CD 1)",22,34,7,0,63
"Prince William County",-,"110 - Buckland Mills (CD 10)",25,76,8,0,109
"Prince William County",-,"111 - Bristow Run (CD 1)",108,183,27,0,318
"Prince William County",-,"112 - Burke-nickens (CD 1)",2,4,0,0,6
"Prince William County",-,"112 - Burke-nickens (CD 10)",52,114,12,0,178
"Prince William County",-,"201 - Saunders (CD 11)",31,58,4,0,93
"Prince William County",-,"202 - Marshall (CD 1)",102,254,31,0,387
"Prince William County",-,"203 - Bennett (CD 1)",61,177,24,0,262
"Prince William County",-,"204 - Ellis (CD 1)",58,116,13,0,187
"Prince William County",-,"205 - Buckhall (CD 10)",62,202,9,0,273
"Prince William County",-,"206 - Coles (CD 1)",88,199,23,1,311
"Prince William County",-,"207 - Spriggs (CD 1)",92,119,14,0,225
"Prince William County",-,"208 - Hylton (CD 1)",71,159,18,0,248
"Prince William County",-,"209 - Independent Hill (CD 1)",71,184,19,0,274
"Prince William County",-,"210 - Penn (CD 1)",70,222,21,0,313
"Prince William County",-,"210 - Penn (CD 11)",6,8,0,0,14
"Prince William County",-,"211 - Signal Hill (CD 10)",38,188,17,0,243
"Prince William County",-,"212 - Yorkshire (CD 10)",46,140,12,0,198
"Prince William County",-,"213 - Saratoga (CD 1)",25,71,11,0,107
"Prince William County",-,"214 - Lucasville (CD 1)",47,152,18,0,217
"Prince William County",-,"215 - Rosa Parks (CD 11)",31,77,9,0,117
"Prince William County",-,"301 - Dumfries (CD 11)",27,54,6,0,87
"Prince William County",-,"302 - Potomac (CD 11)",27,36,4,0,67
"Prince William County",-,"303 - Graham Park (CD 11)",13,26,3,0,42
"Prince William County",-,"304 - Quantico (CD 1)",10,22,1,0,33
"Prince William County",-,"305 - Pattie (CD 1)",89,94,28,0,211
"Prince William County",-,"306 - Washington-reid (CD 1)",123,146,26,0,295
"Prince William County",-,"307 - Henderson (CD 1)",94,136,11,0,241
"Prince William County",-,"308 - Montclair (CD 1)",50,76,18,0,144
"Prince William County",-,"309 - Ashland (CD 1)",52,90,9,0,151
"Prince William County",-,"310 - Forest Park (CD 1)",41,85,12,0,138
"Prince William County",-,"311 - Swans Creek (CD 11)",35,76,8,0,119
"Prince William County",-,"312 - Triangle (CD 1)",2,16,1,0,19
"Prince William County",-,"312 - Triangle (CD 11)",40,72,18,0,130
"Prince William County",-,"313 - Cardinal (CD 1)",49,53,10,0,112
"Prince William County",-,"314 - Cabin Branch (CD 1)",47,55,13,1,116
"Prince William County",-,"401 - Evergreen (CD 10)",111,245,30,0,386
"Prince William County",-,"402 - Battlefield (CD 10)",113,197,21,0,331
"Prince William County",-,"403 - Bull Run (CD 10)",40,77,26,0,143
"Prince William County",-,"404 - Ben Lomond (CD 1)",25,66,11,0,102
"Prince William County",-,"405 - Stonewall (CD 1)",45,88,15,0,148
"Prince William County",-,"406 - Alvey (CD 10)",103,107,7,0,217
"Prince William County",-,"407 - Heritage Hunt (CD 10)",266,383,60,0,709
"Prince William County",-,"408 - Sudley (CD 1)",35,136,22,0,193
"Prince William County",-,"409 - Tyler (CD 10)",47,99,12,0,158
"Prince William County",-,"410 - Mountain View (CD 10)",76,144,12,0,232
"Prince William County",-,"411 - Mullen (CD 1)",7,41,7,0,55
"Prince William County",-,"412 - Catharpin (CD 10)",70,152,16,0,238
"Prince William County",-,"413 - Reagan (CD 10)",78,182,17,0,277
"Prince William County",-,"501 - Lake Ridge (CD 1)",53,109,11,0,173
"Prince William County",-,"502 - Occoquan (CD 11)",42,60,15,0,117
"Prince William County",-,"503 - Old Bridge (CD 11)",29,66,10,0,105
"Prince William County",-,"504 - Rockledge (CD 11)",77,124,26,0,227
"Prince William County",-,"505 - Mohican (CD 1)",72,98,17,0,187
"Prince William County",-,"506 - Bethel (CD 11)",65,143,17,0,225
"Prince William County",-,"507 - Chinn (CD 11)",73,103,11,0,187
"Prince William County",-,"508 - Springwoods (CD 1)",34,39,12,0,85
"Prince William County",-,"509 - Mc Coart (CD 1)",105,226,29,0,360
"Prince William County",-,"510 - Yates Ford (CD 10)",71,161,28,0,260
"Prince William County",-,"511 - Westridge (CD 1)",52,106,18,0,176
"Prince William County",-,"512 - York (CD 11)",18,36,6,0,60
"Prince William County",-,"513 - Lynnwood (CD 11)",100,146,38,0,284
"Prince William County",-,"514 - Antietam (CD 11)",74,148,20,0,242
"Prince William County",-,"601 - Dale (CD 11)",23,35,8,0,66
"Prince William County",-,"602 - Beville (CD 11)",45,85,15,0,145
"Prince William County",-,"603 - Hampton (CD 11)",15,32,5,0,52
"Prince William County",-,"604 - Gideon (CD 11)",23,65,3,0,91
"Prince William County",-,"605 - Minnieville (CD 11)",27,92,6,0,125
"Prince William County",-,"606 - Bel Air (CD 11)",33,83,9,0,125
"Prince William County",-,"607 - Kerrydale (CD 11)",24,81,13,0,118
"Prince William County",-,"608 - Enterprise (CD 11)",33,74,11,0,118
"Prince William County",-,"609 - King (CD 1)",0,0,0,0,0
"Prince William County",-,"609 - King (CD 11)",33,108,9,0,150
"Prince William County",-,"610 - Fitzgerald (CD 11)",41,73,10,0,124
"Prince William County",-,"611 - Neabsco (CD 11)",18,57,10,0,85
"Prince William County",-,"701 - Belmont (CD 11)",59,90,15,0,164
"Prince William County",-,"702 - Library (CD 11)",36,36,8,0,80
"Prince William County",-,"703 - Lynn (CD 11)",11,21,4,0,36
"Prince William County",-,"704 - Porter (CD 11)",19,30,6,0,55
"Prince William County",-,"705 - Potomac View (CD 11)",25,93,14,0,132
"Prince William County",-,"706 - Rippon (CD 11)",40,99,11,0,150
"Prince William County",-,"707 - Kilby (CD 11)",13,54,4,0,71
"Prince William County",-,"708 - River Oaks (CD 11)",21,21,4,0,46
"Prince William County",-,"709 - Freedom (CD 11)",21,40,4,0,65
"Prince William County",-,"710 - Powells Creek (CD 11)",6,15,4,0,25
"Prince William County",-,"711 - Grayson (CD 11)",21,56,5,0,82
"Prince William County",-,"712 - Leesylvania (CD 11)",63,99,14,0,176
"Prince William County",-,"Ab - Central Absentee Precinct (CD 1)",144,165,39,0,348
"Prince William County",-,"Ab - Central Absentee Precinct (CD 10)",51,69,11,0,131
"Prince William County",-,"Ab - Central Absentee Precinct (CD 11)",108,108,32,0,248
"Prince William County",-,"Provisional (CD 1)",11,13,4,0,28
"Prince William County",-,"Provisional (CD 10)",0,1,0,0,1
"Prince William County",-,"Provisional (CD 11)",0,0,0,0,0
"Pulaski County",-,"101 - Belspring",22,27,1,0,50
"Pulaski County",-,"102 - New River",71,66,13,0,150
"Pulaski County",-,"103 - West Cloyd",33,38,10,0,81
"Pulaski County",-,"201 - Draper",42,59,6,0,107
"Pulaski County",-,"202 - South Pulaski",8,6,0,0,14
"Pulaski County",-,"203 - Newbern",54,64,6,0,124
"Pulaski County",-,"301 - Dublin",48,59,9,0,116
"Pulaski County",-,"302 - Hiwassee",10,18,1,0,29
"Pulaski County",-,"304 - Snowville",35,39,6,0,80
"Pulaski County",-,"401 - Massie",83,77,12,0,172
"Pulaski County",-,"402 - Walker",22,31,5,0,58
"Pulaski County",-,"501 - Robinson",73,49,5,0,127
"Pulaski County",-,"Ab - Central Absentee Precinct",15,7,0,0,22
"Pulaski County",-,Provisional,0,0,0,0,0
"Radford City",-,"1 - East Precinct",48,31,8,0,87
"Radford City",-,"2 - Central Precinct",79,46,19,0,144
"Radford City",-,"3 - West Precinct",63,68,11,0,142
"Radford City",-,"Ab - Central Absentee Precinct",8,3,4,0,15
"Radford City",-,Provisional,1,0,0,0,1
"Rappahannock County",-,"101 - Washington",52,49,12,0,113
"Rappahannock County",-,"201 - Amissville",42,75,5,0,122
"Rappahannock County",-,"301 - Sperryville",35,45,18,0,98
"Rappahannock County",-,"401 - Scrabble",33,46,7,0,86
"Rappahannock County",-,"501 - Chester Gap",6,50,3,0,59
"Rappahannock County",-,"502 - Flint Hill",32,32,7,0,71
"Rappahannock County",-,"Ab - Central Absentee Precinct",17,7,0,0,24
"Rappahannock County",-,Provisional,0,2,0,0,2
"Richmond County",-,"101 - Precinct 1-1",20,18,9,0,47
"Richmond County",-,"201 - Precinct 2-1",23,28,5,0,56
"Richmond County",-,"301 - Precinct 3-1",46,29,5,0,80
"Richmond County",-,"401 - Precinct 4-1",29,37,16,0,82
"Richmond County",-,"501 - Precinct 5-1",39,28,9,0,76
"Richmond County",-,"Ab - Central Absentee Precinct",5,1,1,0,7
"Richmond County",-,Provisional,0,0,0,0,0
"Richmond City",-,"101 - One Hundred One (CD 4)",132,28,29,0,189
"Richmond City",-,"102 - One Hundred Two (CD 4)",90,17,22,0,129
"Richmond City",-,"104 - One Hundred Four (CD 4)",152,29,17,0,198
"Richmond City",-,"105 - One Hundred Five (CD 4)",96,17,23,0,136
"Richmond City",-,"106 - One Hundred Six (CD 4)",211,45,23,0,279
"Richmond City",-,"111 - One Hundred Eleven (CD 4)",73,34,14,0,121
"Richmond City",-,"112 - One Hundred Twelve (CD 4)",71,20,11,0,102
"Richmond City",-,"113 - One Hundred Thirteen (CD 4)",52,19,11,0,82
"Richmond City",-,"114 - One Hundred Fourteen (CD 4)",68,28,17,0,113
"Richmond City",-,"203 - Two Hundred Three (CD 4)",51,14,11,0,76
"Richmond City",-,"204 - Two Hundred Four (CD 4)",68,24,11,0,103
"Richmond City",-,"206 - Two Hundred Six (CD 4)",15,10,7,0,32
"Richmond City",-,"207 - Two Hundred Seven (CD 4)",47,38,6,0,91
"Richmond City",-,"208 - Two Hundred Eight (CD 4)",56,36,19,0,111
"Richmond City",-,"213 - Two Hundred Thirteen (CD 4)",10,7,2,0,19
"Richmond City",-,"301 - Three Hundred One (CD 4)",3,2,2,0,7
"Richmond City",-,"302 - Three Hundred Two (CD 4)",21,6,7,0,34
"Richmond City",-,"303 - Three Hundred Three (CD 4)",7,3,1,0,11
"Richmond City",-,"304 - Three Hundred Four (CD 4)",3,1,2,0,6
"Richmond City",-,"305 - Three Hundred Five (CD 4)",5,5,3,0,13
"Richmond City",-,"306 - Three Hundred Six (CD 4)",2,1,0,0,3
"Richmond City",-,"307 - Three Hundred Seven (CD 4)",33,17,8,0,58
"Richmond City",-,"308 - Three Hundred Eight (CD 4)",39,19,12,0,70
"Richmond City",-,"309 - Three Hundred Nine (CD 4)",74,31,7,0,112
"Richmond City",-,"310 - Three Hundred Ten (CD 4)",0,0,0,0,0
"Richmond City",-,"402 - Four Hundred Two (CD 4)",82,42,25,0,149
"Richmond City",-,"404 - Four Hundred Four (CD 4)",31,44,18,0,93
"Richmond City",-,"409 - Four Hundred Nine (CD 4)",171,87,45,0,303
"Richmond City",-,"410 - Four Hundred Ten (CD 4)",45,35,24,0,104
"Richmond City",-,"412 - Four Hundred Twelve (CD 4)",46,34,11,0,91
"Richmond City",-,"413 - Four Hundred Thirteen (CD 4)",70,48,22,2,142
"Richmond City",-,"414 - Four Hundred Fourteen (CD 4)",98,46,45,0,189
"Richmond City",-,"501 - Five Hundred One (CD 4)",21,18,2,0,41
"Richmond City",-,"503 - Five Hundred Three (CD 4)",15,5,4,0,24
"Richmond City",-,"504 - Five Hundred Four (CD 4)",22,5,11,0,38
"Richmond City",-,"505 - Five Hundred Five (CD 4)",3,11,3,0,17
"Richmond City",-,"508 - Five Hundred Eight (CD 4)",32,7,11,0,50
"Richmond City",-,"509 - Five Hundred Nine (CD 4)",6,7,2,0,15
"Richmond City",-,"510 - Five Hundred Ten (CD 4)",6,6,1,0,13
"Richmond City",-,"602 - Six Hundred Two (CD 4)",1,0,0,0,1
"Richmond City",-,"603 - Six Hundred Three (CD 4)",4,5,1,0,10
"Richmond City",-,"604 - Six Hundred Four (CD 4)",2,3,0,0,5
"Richmond City",-,"606 - Six Hundred Six (CD 4)",4,2,4,0,10
"Richmond City",-,"607 - Six Hundred Seven (CD 4)",21,9,2,0,32
"Richmond City",-,"609 - Six Hundred Nine (CD 4)",8,8,1,0,17
"Richmond City",-,"610 - Six Hundred Ten (CD 4)",1,0,1,0,2
"Richmond City",-,"701 - Seven Hundred One (CD 4)",1,2,0,0,3
"Richmond City",-,"702 - Seven Hundred Two (CD 4)",2,2,0,0,4
"Richmond City",-,"703 - Seven Hundred Three (CD 4)",3,0,2,0,5
"Richmond City",-,"705 - Seven Hundred Five (CD 4)",6,6,5,0,17
"Richmond City",-,"706 - Seven Hundred Six (CD 4)",14,12,2,0,28
"Richmond City",-,"707 - Seven Hundred Seven (CD 4)",34,25,11,0,70
"Richmond City",-,"708 - Seven Hundred Eight (CD 4)",17,7,8,0,32
"Richmond City",-,"802 - Eight Hundred Two (CD 4)",0,3,1,0,4
"Richmond City",-,"806 - Eight Hundred Six (CD 4)",6,11,3,0,20
"Richmond City",-,"810 - Eight Hundred Ten (CD 4)",9,9,4,0,22
"Richmond City",-,"811 - Eight Hundred Eleven (CD 4)",8,4,5,0,17
"Richmond City",-,"812 - Eight Hundred Twelve (CD 4)",24,25,4,0,53
"Richmond City",-,"814 - Eight Hundred Fourteen (CD 4)",5,5,0,0,10
"Richmond City",-,"902 - Nine Hundred Two (CD 4)",4,0,0,0,4
"Richmond City",-,"903 - Nine Hundred Three (CD 4)",6,12,6,0,24
"Richmond City",-,"908 - Nine Hundred Eight (CD 4)",10,10,5,0,25
"Richmond City",-,"909 - Nine Hundred Nine (CD 4)",8,15,5,0,28
"Richmond City",-,"910 - Nine Hundred Ten (CD 4)",13,7,4,0,24
"Richmond City",-,"911 - Nine Hundred Eleven (CD 4)",5,4,0,0,9
"Richmond City",-,"AB - Central Absentee Precinct (CD 4)",71,8,13,0,92
"Richmond City",-,"Provisional (CD 4)",0,0,0,0,0
"Roanoke County",-,"101 - Catawba (CD 9)",28,41,5,0,74
"Roanoke County",-,"102 - Mason Valley (CD 9)",34,33,9,0,76
"Roanoke County",-,"103 - Glenvar (CD 9)",58,76,20,0,154
"Roanoke County",-,"104 - Northside (CD 9)",41,44,9,0,94
"Roanoke County",-,"105 - Peters Creek (CD 9)",122,94,29,0,245
"Roanoke County",-,"106 - Green Hill (CD 9)",79,100,29,0,208
"Roanoke County",-,"107 - Bennett Springs (CD 9)",38,42,11,0,91
"Roanoke County",-,"108 - Wildwood (CD 9)",28,67,7,1,103
"Roanoke County",-,"201 - Plantation (CD 6)",108,86,19,0,213
"Roanoke County",-,"202 - Burlington (CD 6)",69,54,13,0,136
"Roanoke County",-,"203 - Mountain View (CD 6)",219,172,57,0,448
"Roanoke County",-,"204 - Botetourt Springs (CD 9)",164,103,46,0,313
"Roanoke County",-,"205 - Orchards (CD 6)",256,174,54,0,484
"Roanoke County",-,"206 - Hollins (CD 6)",57,53,6,0,116
"Roanoke County",-,"301 - Bent Mountain (CD 9)",32,49,7,0,88
"Roanoke County",-,"302 - Poages Mill (CD 6)",181,155,32,0,368
"Roanoke County",-,"303 - Windsor Hills (CD 6)",95,88,22,0,205
"Roanoke County",-,"304 - Oak Grove (CD 6)",246,142,42,0,430
"Roanoke County",-,"305 - Castle Rock (CD 6)",238,130,52,0,420
"Roanoke County",-,"306 - Garst Mill (CD 6)",73,64,13,0,150
"Roanoke County",-,"402 - Bonsack (CD 6)",51,27,15,0,93
"Roanoke County",-,"403 - North Vinton (CD 6)",104,80,19,0,203
"Roanoke County",-,"404 - South Vinton (CD 6)",121,73,22,0,216
"Roanoke County",-,"405 - Lindenwood (CD 6)",247,158,45,0,450
"Roanoke County",-,"406 - Mount Pleasant (CD 6)",133,126,20,0,279
"Roanoke County",-,"501 - Cotton Hill (CD 6)",58,55,6,0,119
"Roanoke County",-,"502 - Penn Forest (CD 6)",60,41,13,0,114
"Roanoke County",-,"503 - Cave Spring (CD 6)",88,60,15,0,163
"Roanoke County",-,"504 - Ogden (CD 6)",35,46,7,0,88
"Roanoke County",-,"505 - Clearbrook (CD 6)",59,68,9,0,136
"Roanoke County",-,"506 - Mount Vernon (CD 6)",61,40,13,0,114
"Roanoke County",-,"507 - Hunting Hills (CD 6)",129,80,32,0,241
"Roanoke County",-,"Ab - Central Absentee Precinct (CD 6)",120,53,38,0,211
"Roanoke County",-,"Ab - Central Absentee Precinct (CD 9)",23,17,4,0,44
"Roanoke County",-,"Provisional (CD 6)",0,0,0,0,0
"Roanoke County",-,"Provisional (CD 9)",0,0,0,0,0
"Roanoke City",-,"1 -Peters Creek",18,25,1,0,44
"Roanoke City",-,"2 - Grandview",49,46,8,0,103
"Roanoke City",-,"3 -Preston Park",80,88,15,0,183
"Roanoke City",-,"4 - Williamson Road",32,67,5,0,104
"Roanoke City",-,"5 - East Gate",47,74,13,0,134
"Roanoke City",-,"6 - Hollins Road",29,37,7,0,73
"Roanoke City",-,"7 - Southeast",35,39,14,0,88
"Roanoke City",-,"8 - Lincoln Terrace",8,2,1,0,11
"Roanoke City",-,"9 - Highland",27,29,8,0,64
"Roanoke City",-,"10 - Old Southwest-Wasena",40,34,12,0,86
"Roanoke City",-,"11 - Raleigh Court",66,55,17,0,138
"Roanoke City",-,"12 - South Roanoke",135,46,21,0,202
"Roanoke City",-,"13 - Garden City",49,69,13,0,131
"Roanoke City",-,"14 - Crystal Spring",125,41,29,0,195
"Roanoke City",-,"15 - Grandin Court",71,59,19,0,149
"Roanoke City",-,"16 - Deyerle",154,91,28,0,273
"Roanoke City",-,"17 - Lee-Hi",62,49,13,0,124
"Roanoke City",-,"18 - Virginia Heights-Norwich",27,52,10,0,89
"Roanoke City",-,"19 - Summit Hills",46,65,11,0,122
"Roanoke City",-,"20 - Forest Park",6,3,5,0,14
"Roanoke City",-,"21 - Eureka Park",10,11,1,0,22
"Roanoke City",-,"Ab - Central Absentee Precinct",33,22,3,0,58
"Roanoke City",-,Provisional,1,1,0,0,2
"Rockbridge County",-,"101 - Airport",73,28,18,0,119
"Rockbridge County",-,"102 - Ben Salem",54,32,7,0,93
"Rockbridge County",-,"103 - Plank Road",23,26,6,0,55
"Rockbridge County",-,"104 - Effinger",32,33,4,0,69
"Rockbridge County",-,"201 - Collierstown",46,23,7,0,76
"Rockbridge County",-,"202 - Highland Belle",96,69,14,0,179
"Rockbridge County",-,"203 - Vo-tech",20,12,5,0,37
"Rockbridge County",-,"301 - Maury River",25,14,6,0,45
"Rockbridge County",-,"302 - Natural Bridge",24,34,2,0,60
"Rockbridge County",-,"303 - Falling Spring",15,17,3,0,35
"Rockbridge County",-,"401 - Fairfield",39,37,7,0,83
"Rockbridge County",-,"402 - Mountain View",54,46,13,0,113
"Rockbridge County",-,"403 - Vesuvius",16,14,0,0,30
"Rockbridge County",-,"501 - Goshen",21,26,3,0,50
"Rockbridge County",-,"502 - Meadowview",34,34,4,0,72
"Rockbridge County",-,"503 - Rockbridge Baths",22,20,2,0,44
"Rockbridge County",-,"504 - Rockbridge",48,51,4,0,103
"Rockbridge County",-,"Ab - Central Absentee Precinct",24,14,7,0,45
"Rockbridge County",-,Provisional,0,0,0,0,0
"Rockingham County",-,"101 - Broadway",96,102,9,0,207
"Rockingham County",-,"102 - Timberville",26,49,6,0,81
"Rockingham County",-,"103 - Fulks Run",41,64,1,0,106
"Rockingham County",-,"104 - Bergton",20,34,3,0,57
"Rockingham County",-,"105 - Lacey Spring",41,52,3,0,96
"Rockingham County",-,"106 - Tenth Legion",21,51,6,0,78
"Rockingham County",-,"107 - Plains",32,54,5,0,91
"Rockingham County",-,"108 - Little North Mountain",19,37,5,0,61
"Rockingham County",-,"201 - Singers Glen",34,82,1,0,117
"Rockingham County",-,"202 - Edom",54,103,11,0,168
"Rockingham County",-,"203 - Dayton",33,47,5,0,85
"Rockingham County",-,"204 - Mt Clinton",53,73,4,0,130
"Rockingham County",-,"205 - Silver Lake",83,105,11,0,199
"Rockingham County",-,"301 - Keezletown",41,63,6,0,110
"Rockingham County",-,"302 - Port Republic",47,98,5,0,150
"Rockingham County",-,"303 - Melrose",23,47,7,0,77
"Rockingham County",-,"304 - Grottoes",40,87,5,0,132
"Rockingham County",-,"305 - Massanetta Springs",71,75,10,0,156
"Rockingham County",-,"306 - Cross Keys",32,51,5,0,88
"Rockingham County",-,"307 - Crossroads",148,121,12,0,281
"Rockingham County",-,"401 - Bridgewater",133,156,24,0,313
"Rockingham County",-,"402 - Montezuma",40,71,5,0,116
"Rockingham County",-,"403 - Mt Crawford",9,10,3,0,22
"Rockingham County",-,"404 - North River",34,76,10,0,120
"Rockingham County",-,"405 - Ottobine",34,98,6,0,138
"Rockingham County",-,"501 - Elkton",26,81,3,0,110
"Rockingham County",-,"502 - Swift Run",37,113,11,0,161
"Rockingham County",-,"503 - Mcgaheysville",59,96,13,0,168
"Rockingham County",-,"504 - South Fork",25,54,3,0,82
"Rockingham County",-,"505 - Stony Run",45,101,16,0,162
"Rockingham County",-,"Ab - Central Absentee Precinct",97,42,7,0,146
"Rockingham County",-,Provisional,0,0,0,0,0
"Russell County",-,"101 - Moccasin",19,18,0,0,37
"Russell County",-,"102 - Copper Creek",2,36,0,0,38
"Russell County",-,"103 - South Castlewood",5,17,3,0,25
"Russell County",-,"201 - North Castlewood",14,45,0,0,59
"Russell County",-,"202 - Dante",1,13,2,0,16
"Russell County",-,"301 - Cooks Mill",2,6,1,0,9
"Russell County",-,"302 - Daugherty",1,15,0,0,16
"Russell County",-,"303 - New Garden",7,13,0,0,20
"Russell County",-,"304 - Cleveland",4,11,0,0,15
"Russell County",-,"401 - Drill",2,4,0,0,6
"Russell County",-,"402 - Swords Creek",9,51,1,0,61
"Russell County",-,"403 - Honaker",3,16,2,0,21
"Russell County",-,"501 - West Lebanon",25,60,4,0,89
"Russell County",-,"601 - East Lebanon",6,63,0,0,69
"Russell County",-,"602 - Elk Garden",13,46,0,0,59
"Russell County",-,"Ab - Central Absentee Precinct",16,14,2,0,32
"Russell County",-,Provisional,0,0,0,0,0
"Salem City",-,"1 - North Salem No 2",83,67,23,0,173
"Salem City",-,"2 - Conehurst",23,20,4,0,47
"Salem City",-,"3 - Beverly Heights",39,54,9,0,102
"Salem City",-,"4 - West Salem",72,60,14,0,146
"Salem City",-,"5 - North Salem No 1",42,61,12,0,115
"Salem City",-,"6 - South Salem No 1",31,34,7,0,72
"Salem City",-,"7 - South Salem No 2",36,61,8,0,105
"Salem City",-,"8 - East Salem",24,21,5,0,50
"Salem City",-,"9 - South Side Hills",75,96,27,0,198
"Salem City",-,"10 - Hidden Valley",98,57,25,0,180
"Salem City",-,"Ab - Central Absentee Precinct",28,9,2,0,39
"Salem City",-,Provisional,0,0,0,0,0
"Scott County",-,"101 - Weber City",18,22,6,0,46
"Scott County",-,"102 - Yuma",10,38,1,0,49
"Scott County",-,"202 - Weber City East",12,34,4,0,50
"Scott County",-,"203 - Hiltons",16,27,2,0,45
"Scott County",-,"204 - Clark's",3,10,0,0,13
"Scott County",-,"301 - Nickelsville",4,26,0,0,30
"Scott County",-,"302 - Snowflake",9,27,1,0,37
"Scott County",-,"303 - Twin Springs",6,7,6,0,19
"Scott County",-,"304 - Copper Creek",0,1,0,0,1
"Scott County",-,"401 - Gate City",39,72,4,0,115
"Scott County",-,"501 - Dungannon",6,15,0,0,21
"Scott County",-,"502 - Fort Blackmore",1,14,0,0,15
"Scott County",-,"503 - Manville",10,11,0,0,21
"Scott County",-,"504 - Rye Cove",6,37,1,0,44
"Scott County",-,"601 - Clinchport",6,16,2,0,24
"Scott County",-,"602 - Duffield-pattonsville",15,33,2,0,50
"Scott County",-,"603 - Fairview",2,3,0,0,5
"Scott County",-,"Ab - Central Absentee Precinct",17,10,1,0,28
"Scott County",-,Provisional,0,0,0,0,0
"Shenandoah County",-,"101 - Orkney Springs",77,87,11,0,175
"Shenandoah County",-,"103 - New Market",145,168,17,0,330
"Shenandoah County",-,"201 - Conicville",81,105,14,0,200
"Shenandoah County",-,"202 - Mt Jackson",100,76,13,0,189
"Shenandoah County",-,"302 - Edinburg",108,101,13,0,222
"Shenandoah County",-,"303 - St Luke",79,116,6,0,201
"Shenandoah County",-,"304 - Fort Valley",46,76,18,0,140
"Shenandoah County",-,"401 - Woodstock",176,147,12,0,335
"Shenandoah County",-,"501 - Cedar Creek",3,18,0,0,21
"Shenandoah County",-,"503 - Toms Brook",107,136,11,0,254
"Shenandoah County",-,"504 - Lebanon Church",64,80,8,0,152
"Shenandoah County",-,"601 - Strasburg",122,139,14,0,275
"Shenandoah County",-,"Ab - Central Absentee Precinct",40,17,2,0,59
"Shenandoah County",-,Provisional,5,3,0,0,8
"Smyth County",-,"101 - Saltville",26,86,5,0,117
"Smyth County",-,"201 - Seven Mile Ford",8,62,0,0,70
"Smyth County",-,"202 - Rich Valley",9,16,1,0,26
"Smyth County",-,"301 - Chilhowie",28,93,4,0,125
"Smyth County",-,"302 - St Clair",2,15,7,0,24
"Smyth County",-,"401 - East Park",14,52,8,0,74
"Smyth County",-,"402 - West Park",12,21,1,0,34
"Smyth County",-,"501 - Atkins",18,43,6,0,67
"Smyth County",-,"502 - Wassona",20,40,7,0,67
"Smyth County",-,"601 - Royal Oak East",16,51,9,0,76
"Smyth County",-,"602 - Royal Oak West",5,33,1,0,39
"Smyth County",-,"701 - Adwolfe",12,70,4,0,86
"Smyth County",-,"702 - Sugar Grove",19,33,5,0,57
"Smyth County",-,"703 - Konnarock",0,15,0,0,15
"Smyth County",-,"Ab - Central Absentee Precinct",2,7,1,0,10
"Smyth County",-,Provisional,0,0,0,0,0
"Southampton County",-,"101 - Berlin",50,39,29,0,118
"Southampton County",-,"102 - Ivor",79,48,26,0,153
"Southampton County",-,"201 - Boykins",32,23,13,0,68
"Southampton County",-,"202 - Branchville",18,14,16,0,48
"Southampton County",-,"301 - Capron",35,21,21,0,77
"Southampton County",-,"302 - Sebrell",42,30,16,0,88
"Southampton County",-,"401 - Drewryville",20,9,9,0,38
"Southampton County",-,"501 - Hunterdale",93,67,27,0,187
"Southampton County",-,"502 - Forks-of-the-river",25,20,8,0,53
"Southampton County",-,"601 - Courtland",45,39,19,0,103
"Southampton County",-,"602 - Sedley",61,26,13,0,100
"Southampton County",-,"701 - Blackwater River",19,10,4,0,33
"Southampton County",-,"702 - Newsoms",29,28,14,0,71
"Southampton County",-,"Ab - Central Absentee Precinct",20,2,7,0,29
"Southampton County",-,Provisional,0,0,0,0,0
"Spotsylvania County",-,"101 - Partlow (CD 7)",94,109,12,0,215
"Spotsylvania County",-,"102 - Blaydes Corner (CD 7)",90,106,22,0,218
"Spotsylvania County",-,"103 - Travelers Rest (CD 1)",0,1,0,0,1
"Spotsylvania County",-,"103 - Travelers Rest (CD 7)",144,148,19,0,311
"Spotsylvania County",-,"104 - Massaponax (CD 1)",128,116,28,0,272
"Spotsylvania County",-,"201 - Wilderness School (CD 7)",124,105,22,0,251
"Spotsylvania County",-,"202 - Wilderness Fire (CD 7)",109,147,11,0,267
"Spotsylvania County",-,"203 - Ni River / Elys Ford (CD 7)",155,109,26,0,290
"Spotsylvania County",-,"204 - Chancellor (CD 7)",115,108,27,0,250
"Spotsylvania County",-,"301 - Plank Road (CD 7)",148,134,24,0,306
"Spotsylvania County",-,"302 - Hazel Run (CD 7)",119,117,22,0,258
"Spotsylvania County",-,"303 - Riverbend (CD 7)",198,203,35,0,436
"Spotsylvania County",-,"401 - Summit (CD 1)",166,98,31,0,295
"Spotsylvania County",-,"402 - Parkside (CD 1)",99,75,22,0,196
"Spotsylvania County",-,"402 - Parkside (CD 7)",19,25,4,0,48
"Spotsylvania County",-,"403 - Lee Hill (CD 1)",221,163,44,0,428
"Spotsylvania County",-,"501 - Belmont (CD 7)",105,116,18,0,239
"Spotsylvania County",-,"502 - Brokenburg (CD 7)",85,94,20,0,199
"Spotsylvania County",-,"503 - Post Oak (CD 7)",139,124,19,0,282
"Spotsylvania County",-,"504 - Courthouse (CD 7)",147,135,34,0,316
"Spotsylvania County",-,"505 - Brock (CD 7)",267,168,37,0,472
"Spotsylvania County",-,"601 - Salem (CD 7)",142,120,36,0,298
"Spotsylvania County",-,"602 - Smith Station (CD 7)",190,156,34,0,380
"Spotsylvania County",-,"603 - Piedmont (CD 7)",92,84,16,0,192
"Spotsylvania County",-,"701 - Battlefield (CD 1)",158,91,21,0,270
"Spotsylvania County",-,"702 - Brents Mill (CD 1)",66,56,16,0,138
"Spotsylvania County",-,"702 - Brents Mill (CD 7)",72,59,17,0,148
"Spotsylvania County",-,"703 - Fairview (CD 1)",12,21,4,0,37
"Spotsylvania County",-,"703 - Fairview (CD 7)",34,22,9,0,65
"Spotsylvania County",-,"704 - Gayle (CD 1)",119,64,27,0,210
"Spotsylvania County",-,"704 - Gayle (CD 7)",121,98,26,0,245
"Spotsylvania County",-,"Ab - Central Absentee Precinct (CD 1)",55,22,16,0,93
"Spotsylvania County",-,"Ab - Central Absentee Precinct (CD 7)",156,83,23,0,262
"Spotsylvania County",-,"Provisional (CD 1)",0,0,0,0,0
"Spotsylvania County",-,"Provisional (CD 7)",0,0,0,0,0
"Stafford County",-,"101 - Hartwood",172,345,39,0,556
"Stafford County",-,"102 - Rocky Run",135,112,26,0,273
"Stafford County",-,"103 - Simpson",110,128,20,0,258
"Stafford County",-,"104 - College",114,191,36,0,341
"Stafford County",-,"201 - Rock Hill",98,130,33,0,261
"Stafford County",-,"202 - Roseville",98,132,22,0,252
"Stafford County",-,"203 - Ruby",79,200,30,0,309
"Stafford County",-,"204 - Stefaniga",174,185,24,0,383
"Stafford County",-,"301 - Griffis",48,49,14,0,111
"Stafford County",-,"302 - Widewater",75,108,18,0,201
"Stafford County",-,"303 - Harbour",134,117,52,0,303
"Stafford County",-,"304 - Barrett",40,59,4,0,103
"Stafford County",-,"401 - Aquia",22,51,4,0,77
"Stafford County",-,"402 - Courthouse",158,140,36,0,334
"Stafford County",-,"403 - Brooke",269,296,81,0,646
"Stafford County",-,"404 - Government Island",185,187,69,0,441
"Stafford County",-,"501 - Grafton",269,269,54,0,592
"Stafford County",-,"502 - Falmouth",251,163,50,0,464
"Stafford County",-,"503 - Drew",155,128,41,0,324
"Stafford County",-,"504 - Gayle",160,106,22,0,288
"Stafford County",-,"601 - Ferry Farm",299,169,56,0,524
"Stafford County",-,"602 - Chatham",241,157,31,0,429
"Stafford County",-,"603 - White Oak",307,225,57,0,589
"Stafford County",-,"604 - England Run",33,32,12,0,77
"Stafford County",-,"701 - Woodlands",140,129,31,0,300
"Stafford County",-,"702 - Whitson",93,92,26,0,211
"Stafford County",-,"703 - Hampton",188,179,52,0,419
"Stafford County",-,"Ab - Central Absentee Precinct",168,73,44,0,285
"Stafford County",-,Provisional,0,3,0,0,3
"Staunton City",-,"101 - Ward No 1",65,106,18,0,189
"Staunton City",-,"201 - Ward Two",102,153,16,0,271
"Staunton City",-,"301 - Ward No 3",71,108,13,0,192
"Staunton City",-,"401 - Ward No 4",126,78,29,0,233
"Staunton City",-,"501 - Ward No 5",72,88,33,0,193
"Staunton City",-,"Ab - Central Absentee Precinct",23,6,4,0,33
"Staunton City",-,Provisional,1,1,0,0,2
"Suffolk City",-,"101 - Belleharbour (CD 3)",29,18,15,0,62
"Suffolk City",-,"102 - Driver (CD 3)",146,140,134,0,420
"Suffolk City",-,"104 - Bennetts Creek (CD 3)",50,76,45,0,171
"Suffolk City",-,"201 - Ebenezer (CD 3)",127,95,96,0,318
"Suffolk City",-,"202 - Chuckatuck (CD 3)",68,95,82,0,245
"Suffolk City",-,"203 - Kings Fork (CD 3)",71,60,44,0,175
"Suffolk City",-,"204 - Hillpoint (CD 3)",36,32,34,0,102
"Suffolk City",-,"301 - White Marsh (CD 4)",8,27,17,0,52
"Suffolk City",-,"302 - John F Kennedy (CD 3)",9,16,4,0,29
"Suffolk City",-,"302 - John F Kennedy (CD 4)",3,4,1,0,8
"Suffolk City",-,"304 - Nansemond River (CD 3)",54,49,27,0,130
"Suffolk City",-,"305 - Shoulders Hill (CD 3)",19,25,19,0,63
"Suffolk City",-,"401 - Airport (CD 4)",48,45,39,0,132
"Suffolk City",-,"402 - Whaleyville (CD 4)",104,81,61,0,246
"Suffolk City",-,"403 - Southside (CD 4)",2,6,3,0,11
"Suffolk City",-,"404 - Booker T Washington (CD 3)",0,0,0,0,0
"Suffolk City",-,"404 - Booker T Washington (CD 4)",3,5,4,0,12
"Suffolk City",-,"405 - Pittmantown (CD 4)",22,25,20,0,67
"Suffolk City",-,"501 - Kilbys Mill (CD 4)",98,110,59,0,267
"Suffolk City",-,"502 - Holland (CD 4)",108,128,63,0,299
"Suffolk City",-,"504 - Lake Cohoon (CD 3)",54,43,21,0,118
"Suffolk City",-,"504 - Lake Cohoon (CD 4)",102,65,48,0,215
"Suffolk City",-,"601 - Lakeside (CD 4)",77,55,58,0,190
"Suffolk City",-,"602 - Olde Towne (CD 3)",8,10,8,0,26
"Suffolk City",-,"602 - Olde Towne (CD 4)",0,1,0,0,1
"Suffolk City",-,"603 - Elephants Fork/westhaven (CD 4)",21,21,13,0,55
"Suffolk City",-,"604 - Wilroy (CD 3)",41,42,38,0,121
"Suffolk City",-,"605 - Hollywood (CD 3)",0,2,0,0,2
"Suffolk City",-,"702 - Harbourview (CD 3)",100,58,51,0,209
"Suffolk City",-,"704 - Burbage Grant (CD 3)",36,40,42,0,118
"Suffolk City",-,"706 - Huntersville (CD 3)",19,24,8,0,51
"Suffolk City",-,"AB - Central Absentee Precinct (CD 3)",35,9,12,0,56
"Suffolk City",-,"Ab - Central Absentee Precinct (CD 4)",14,7,4,0,25
"Suffolk City",-,"Provisional (CD 3)",0,0,0,0,0
"Suffolk City",-,"Provisional (CD 4)",0,1,0,0,1
"Surry County",-,"101 - Surry",46,57,17,0,120
"Surry County",-,"201 - Bacons Castle",20,26,12,0,58
"Surry County",-,"301 - Dendron",32,22,12,0,66
"Surry County",-,"302 - Walls Bridge",5,10,8,0,23
"Surry County",-,"401 - Carsley",17,30,12,0,59
"Surry County",-,"501 - Claremont",29,30,19,0,78
"Surry County",-,"502 - Spring Grove",2,7,2,0,11
"Surry County",-,Provisional,0,0,0,0,0
"Sussex County",-,"101 - Waverly",18,14,4,0,36
"Sussex County",-,"201 - Stony Creek",19,8,3,0,30
"Sussex County",-,"202 - Little Mill",1,4,0,0,5
"Sussex County",-,"301 - Courthouse",29,29,11,0,69
"Sussex County",-,"302 - Wakefield",20,16,13,0,49
"Sussex County",-,"401 - Mars Hill",23,23,13,0,59
"Sussex County",-,"402 - West Wakefield",0,1,0,0,1
"Sussex County",-,"501 - Henry",13,6,2,0,21
"Sussex County",-,"502 - Yale",6,6,1,0,13
"Sussex County",-,"601 - Blackwater",40,36,8,0,84
"Sussex County",-,"602 - Newville",8,10,3,0,21
"Sussex County",-,"AB - Central Absentee Precinct",4,1,4,0,9
"Sussex County",-,Provisional,0,0,0,0,0
"Tazewell County",-,"101 - Abbs Valley",10,7,0,0,17
"Tazewell County",-,"102 - Tip Top",7,31,4,0,42
"Tazewell County",-,"103 - Boissevain",7,9,0,0,16
"Tazewell County",-,"104 - Falls Mills",17,16,1,0,34
"Tazewell County",-,"106 - Pocahontas",2,4,1,0,7
"Tazewell County",-,"107 - Amonate",1,6,0,0,7
"Tazewell County",-,"109 - Bishop",3,14,2,0,19
"Tazewell County",-,"110 - Adria",4,18,4,0,26
"Tazewell County",-,"111 - Gap Store",10,19,0,0,29
"Tazewell County",-,"112 - Bandy",3,13,0,0,16
"Tazewell County",-,"203 - Burkes Garden",6,6,0,0,12
"Tazewell County",-,"204 - Clear Fork",4,16,1,0,21
"Tazewell County",-,"207 - Freestone",6,8,1,0,15
"Tazewell County",-,"209 - Jeffersonville",45,141,7,0,193
"Tazewell County",-,"214 - Thompson Valley",21,17,3,0,41
"Tazewell County",-,"301 - Cedar Bluff",42,84,8,0,134
"Tazewell County",-,"302 - Baptist Valley",7,7,0,0,14
"Tazewell County",-,"303 - Wardell",14,54,2,0,70
"Tazewell County",-,"305 - Pounding Mill",12,20,4,0,36
"Tazewell County",-,"401 - Richlands",68,73,14,0,155
"Tazewell County",-,"402 - Jewell Ridge",4,8,1,0,13
"Tazewell County",-,"404 - Raven",15,22,1,0,38
"Tazewell County",-,"501 - Springville",19,96,3,0,118
"Tazewell County",-,"502 - Graham",53,149,7,0,209
"Tazewell County",-,"Ab - Central Absentee Precinct",14,26,4,0,44
"Tazewell County",-,Provisional,0,0,0,0,0
"Virginia Beach City",-,"1 - North Beach",188,90,138,0,416
"Virginia Beach City",-,"2 - South Beach",56,54,69,0,179
"Virginia Beach City",-,"3 - Ocean Lakes",52,67,35,0,154
"Virginia Beach City",-,"4 - Linkhorn",113,114,102,0,329
"Virginia Beach City",-,"5 - Seatack",31,39,44,0,114
"Virginia Beach City",-,"6 - Alanton",162,97,136,0,395
"Virginia Beach City",-,"7 - Kingston",109,75,136,0,320
"Virginia Beach City",-,"8 - London Bridge",78,88,63,0,229
"Virginia Beach City",-,"9 - Trantwood",142,161,109,0,412
"Virginia Beach City",-,"10 - Great Neck",176,94,202,0,472
"Virginia Beach City",-,"11 - Cape Henry",140,45,132,0,317
"Virginia Beach City",-,"12 - Plaza",77,66,63,0,206
"Virginia Beach City",-,"13 - Mt Trashmore",111,161,86,0,358
"Virginia Beach City",-,"14 - Malibu",76,83,81,0,240
"Virginia Beach City",-,"15 - Old Donation",42,67,41,0,150
"Virginia Beach City",-,"16 - Aragona",72,92,100,0,264
"Virginia Beach City",-,"17 - Ocean Park",72,64,92,0,228
"Virginia Beach City",-,"18 - Thoroughgood",148,134,139,0,421
"Virginia Beach City",-,"19 - Lake Smith",51,70,76,0,197
"Virginia Beach City",-,"20 - Bayside",82,74,80,0,236
"Virginia Beach City",-,"21 - Davis Corner",32,25,25,0,82
"Virginia Beach City",-,"22 - Point O View",109,88,83,0,280
"Virginia Beach City",-,"23 - Arrowhead",98,87,110,0,295
"Virginia Beach City",-,"24 - Larkspur",64,58,74,0,196
"Virginia Beach City",-,"25 - Avalon",119,150,112,1,382
"Virginia Beach City",-,"26 - Fairfield",140,77,129,0,346
"Virginia Beach City",-,"27 - Edwin",138,100,140,0,378
"Virginia Beach City",-,"28 - Thalia",79,59,101,0,239
"Virginia Beach City",-,"29 - Holland",40,50,30,0,120
"Virginia Beach City",-,"30 - Red Wing",105,74,92,0,271
"Virginia Beach City",-,"31 - Sigma",153,168,134,0,455
"Virginia Beach City",-,"32 - Creeds",54,58,50,0,162
"Virginia Beach City",-,"33 - Capps Shop",73,63,55,0,191
"Virginia Beach City",-,"34 - Blackwater",34,45,28,0,107
"Virginia Beach City",-,"35 - Courthouse",186,197,147,0,530
"Virginia Beach City",-,"36 - Windsor Oaks",84,75,70,0,229
"Virginia Beach City",-,"37 - Chesapeake Beach",62,46,49,0,157
"Virginia Beach City",-,"38 - Witchduck",140,149,215,0,504
"Virginia Beach City",-,"39 - Pembroke",95,100,96,0,291
"Virginia Beach City",-,"40 - Bonney",49,62,54,0,165
"Virginia Beach City",-,"41 - College Park",44,71,48,0,163
"Virginia Beach City",-,"42 - Brandon",90,84,79,0,253
"Virginia Beach City",-,"43 - Bellamy",31,51,49,0,131
"Virginia Beach City",-,"44 - Centerville",103,117,104,0,324
"Virginia Beach City",-,"45 - Timberlake",42,37,40,0,119
"Virginia Beach City",-,"46 - Green Run",40,33,32,0,105
"Virginia Beach City",-,"47 - Kings Grant",169,155,189,0,513
"Virginia Beach City",-,"48 - Wolfsnare",124,85,115,0,324
"Virginia Beach City",-,"49 - Lynnhaven",166,102,152,0,420
"Virginia Beach City",-,"50 - Oceana",22,20,13,0,55
"Virginia Beach City",-,"51 - Stratford Chase",112,89,94,0,295
"Virginia Beach City",-,"52 - Homestead",138,133,108,0,379
"Virginia Beach City",-,"53 - Shannon",107,94,69,1,271
"Virginia Beach City",-,"54 - Cromwell",56,52,55,0,163
"Virginia Beach City",-,"55 - Magic Hollow",39,39,34,0,112
"Virginia Beach City",-,"56 - Edinburgh",55,60,52,0,167
"Virginia Beach City",-,"57 - Sherry Park",63,80,58,0,201
"Virginia Beach City",-,"58 - Glenwood",92,72,70,0,234
"Virginia Beach City",-,"59 - Shelton Park",44,52,63,0,159
"Virginia Beach City",-,"60 - Foxfire",83,83,108,0,274
"Virginia Beach City",-,"61 - Baker",16,13,9,0,38
"Virginia Beach City",-,"62 - Landstown",93,99,81,0,273
"Virginia Beach City",-,"63 - Culver",88,97,64,0,249
"Virginia Beach City",-,"64 - Rosemont Forest",138,112,91,0,341
"Virginia Beach City",-,"65 - Colonial",75,58,70,0,203
"Virginia Beach City",-,"66 - Hunt",77,77,79,0,233
"Virginia Beach City",-,"67 - Eastern Shore",15,26,16,0,57
"Virginia Beach City",-,"68 - Manor",119,112,115,0,346
"Virginia Beach City",-,"69 - Shell",32,44,43,0,119
"Virginia Beach City",-,"70 - Corporate Landing",60,80,52,0,192
"Virginia Beach City",-,"71 - Round Hill",35,41,30,0,106
"Virginia Beach City",-,"72 - Rudee",91,57,99,0,247
"Virginia Beach City",-,"73 - Dahlia",41,38,33,0,112
"Virginia Beach City",-,"74 - Buckner",31,44,28,0,103
"Virginia Beach City",-,"75 - Colony",150,91,147,0,388
"Virginia Beach City",-,"76 - Village",33,29,26,0,88
"Virginia Beach City",-,"77 - Brookwood",55,70,62,0,187
"Virginia Beach City",-,"78 - Indian Lakes",56,59,76,0,191
"Virginia Beach City",-,"79 - Pleasant Hall",27,41,31,0,99
"Virginia Beach City",-,"80 - Chimney Hill",40,56,37,0,133
"Virginia Beach City",-,"81 - Rock Lake",43,58,45,0,146
"Virginia Beach City",-,"82 - Shelburne",48,62,45,0,155
"Virginia Beach City",-,"83 - Strawbridge",90,91,87,0,268
"Virginia Beach City",-,"84 - Tallwood",69,50,52,0,171
"Virginia Beach City",-,"85 - Upton",82,108,87,0,277
"Virginia Beach City",-,"86 - Haygood",130,93,141,0,364
"Virginia Beach City",-,"87 - Hillcrest",86,64,89,0,239
"Virginia Beach City",-,"88 - North Landing",60,60,58,0,178
"Virginia Beach City",-,"89 - Lake Christopher",107,84,88,0,279
"Virginia Beach City",-,"90 - Lake Joyce",55,53,79,0,187
"Virginia Beach City",-,"91 - Lexington",52,52,43,0,147
"Virginia Beach City",-,"92 - Little Neck",121,86,127,0,334
"Virginia Beach City",-,"93 - Newtown",19,12,10,0,41
"Virginia Beach City",-,"94 - Pinewood",56,47,50,0,153
"Virginia Beach City",-,"95 - Dam Neck",25,38,30,0,93
"Virginia Beach City",-,"96 - Hilltop",30,41,40,0,111
"Virginia Beach City",-,"97 - Indian River",43,43,38,0,124
"Virginia Beach City",-,"98 - Independence",43,28,22,0,93
"Virginia Beach City",-,"Ab - Central Absentee Precinct",285,137,264,0,686
"Virginia Beach City",-,Provisional,5,3,5,0,13
"Warren County",-,"101 - Fork Town",71,65,7,0,143
"Warren County",-,"102 - Otterburn",78,147,25,0,250
"Warren County",-,"201 - Happy Creek",81,119,14,0,214
"Warren County",-,"202 - Linden",74,115,21,0,210
"Warren County",-,"301 - North River",59,69,7,0,135
"Warren County",-,"302 - Riverton",78,101,16,0,195
"Warren County",-,"401 - East Shenandoah",97,193,20,0,310
"Warren County",-,"402 - Town - West Shenandoah",58,86,11,0,155
"Warren County",-,"501 - South River",55,101,19,0,175
"Warren County",-,"502 - Bentonville",40,63,8,0,111
"Warren County",-,"504 - Browntown",35,56,9,0,100
"Warren County",-,"Ab - Central Absentee Precinct",27,14,10,0,51
"Warren County",-,Provisional,0,0,0,0,0
"Washington County",-,"101 - East Abingdon",52,95,5,0,152
"Washington County",-,"102 - West Abingdon",19,66,3,0,88
"Washington County",-,"201 - Clinchburg",33,52,6,0,91
"Washington County",-,"202 - Greendale",45,96,7,0,148
"Washington County",-,"203 - Hayters Gap",32,44,6,0,82
"Washington County",-,"204 Woodland Hills",44,92,12,0,148
"Washington County",-,"301 - Watauga",36,138,9,0,183
"Washington County",-,"302 - South Abingdon",30,102,11,0,143
"Washington County",-,"401 - Glade Spring",17,67,4,0,88
"Washington County",-,"402 - Meadowview",31,90,5,0,126
"Washington County",-,"501 - Rhea Valley",21,115,10,0,146
"Washington County",-,"502 - Damascus",19,44,5,0,68
"Washington County",-,"504 - Green Cove",6,18,4,0,28
"Washington County",-,"601 - Burson Place",32,79,2,0,113
"Washington County",-,"602 - Mendota",6,25,4,0,35
"Washington County",-,"603 - Valley Institute",34,79,7,0,120
"Washington County",-,"701 - High Point",31,77,4,0,112
"Washington County",-,"702 - Wallace",19,38,3,0,60
"Washington County",-,"703 - John Battle",34,76,3,0,113
"Washington County",-,"Ab - Central Absentee Precinct",29,28,5,0,62
"Washington County",-,Provisional,0,0,0,0,0
"Waynesboro City",-,"1 - Ward A",25,48,11,0,84
"Waynesboro City",-,"2 - Ward B",129,134,17,0,280
"Waynesboro City",-,"3 - Ward C",51,84,11,0,146
"Waynesboro City",-,"4 - Ward D",151,169,36,0,356
"Waynesboro City",-,"Ab - Central Absentee Precinct",24,8,1,0,33
"Waynesboro City",-,Provisional,0,0,0,0,0
"Westmoreland County",-,"101 - Precinct 1-1",45,23,4,0,72
"Westmoreland County",-,"102 - Precinct 1-2",16,12,4,0,32
"Westmoreland County",-,"201 - Precinct 2-1",80,53,12,0,145
"Westmoreland County",-,"202 - Precinct 2-2",34,46,11,0,91
"Westmoreland County",-,"301 - Precinct 3-1",30,40,11,0,81
"Westmoreland County",-,"302 - Precinct 3-2",15,22,7,0,44
"Westmoreland County",-,"401 - Precinct 4-1",85,92,23,0,200
"Westmoreland County",-,"501 - Precinct 5-1",69,85,39,0,193
"Westmoreland County",-,"Ab - Central Absentee Precinct",18,13,0,0,31
"Westmoreland County",-,Provisional,0,0,0,0,0
"Williamsburg City",-,"1 - Stryker",130,86,46,0,262
"Williamsburg City",-,"2 - Matoaka",147,81,39,0,267
"Williamsburg City",-,"Ab - Central Absentee Precinct",32,11,7,0,50
"Williamsburg City",-,Provisional,0,0,1,0,1
"Winchester City",-,"101 - Merrimans",164,69,26,0,259
"Winchester City",-,"102 - Old Town",114,83,14,0,211
"Winchester City",-,"201 - Virginia Avenue",42,49,12,0,103
"Winchester City",-,"301 - War Memorial",62,69,10,0,141
"Winchester City",-,"401 - Frederick Douglass",31,33,6,0,70
"Winchester City",-,"402 - Rolling Hills",105,98,12,0,215
"Winchester City",-,"Ab - Central Absentee Precinct",29,7,2,0,38
"Winchester City",-,Provisional,0,0,0,0,0
"Wise County",-,"101 - Appalachia",9,20,7,0,36
"Wise County",-,"102 - Dorchester",16,21,3,0,40
"Wise County",-,"103 - Guest River Voting Place",10,26,2,0,38
"Wise County",-,"104 - West Pound",21,41,12,0,74
"Wise County",-,"201 - North Coeburn",16,36,1,0,53
"Wise County",-,"202 - Wise",45,55,12,0,112
"Wise County",-,"203 - East Pound",4,12,3,0,19
"Wise County",-,"301 - Big Stone Gap",30,69,3,0,102
"Wise County",-,"302 - East Stone Gap",32,64,7,0,103
"Wise County",-,"401 - Clinch Valley",26,50,7,0,83
"Wise County",-,"402 - South Coeburn",28,59,1,0,88
"Wise County",-,"403 - St Paul",19,18,3,0,40
"Wise County",-,"Ab - Central Absentee Precinct",23,12,2,0,37
"Wise County",-,Provisional,0,0,0,0,0
"Wythe County",-,"101 - Royal Oak",11,26,0,0,37
"Wythe County",-,"102 - Rural Retreat",58,103,15,0,176
"Wythe County",-,"203 - West Wytheville",63,102,10,0,175
"Wythe County",-,"303 - East Wytheville",77,129,7,0,213
"Wythe County",-,"401 - Fort Chiswell",43,42,6,0,91
"Wythe County",-,"402 - Max Meadows",38,63,3,0,104
"Wythe County",-,"501 - Jackson Memorial",19,41,1,0,61
"Wythe County",-,"502 - Sheffey",50,55,1,0,106
"Wythe County",-,"601 - Huddle",14,28,1,0,43
"Wythe County",-,"602 - Zion",34,44,2,0,80
"Wythe County",-,"603 Evergreen",23,41,3,0,67
"Wythe County",-,"Ab - Central Absentee Precinct",15,11,6,0,32
"Wythe County",-,Provisional,0,0,0,0,0
"York County",-,"101 - Queens Lake",130,95,54,0,279
"York County",-,"102 - Waller Mill",117,130,50,0,297
"York County",-,"103 - Magruder",85,85,24,0,194
"York County",-,"201 - Coventry",162,96,139,0,397
"York County",-,"202 - Kiln Creek",78,52,62,0,192
"York County",-,"301 - Seaford",196,167,181,0,544
"York County",-,"302 - Yorktown",133,98,120,0,351
"York County",-,"303 - Edgehill",109,115,69,0,293
"York County",-,"401 - Harwoods Mill",191,145,142,0,478
"York County",-,"402 - Dare",194,137,130,0,461
"York County",-,"403 - Grafton",99,61,62,0,222
"York County",-,"501 - Tabb",205,144,128,0,477
"York County",-,"502 - Bethel",158,115,78,0,351
"York County",-,"Ab - Central Absentee Precinct",72,34,38,0,144
"York County",-,Provisional,1,1,0,0,2
TOTALS,,,"160,003","155,466","50,313",21,"365,803"
