County/City,Ward,Pct,"Barbara Jean Comstock","Wayshak Edward Hill","All Others","Total Votes Cast"
,,,,
"Clarke County",-,"101 - Russell",166,154,0,320
"Clarke County",-,"201 - Berryville",113,97,0,210
"Clarke County",-,"301 - Millwood",78,83,0,161
"Clarke County",-,"302 - Pine Grove",48,37,0,85
"Clarke County",-,"401 - White Post",119,120,0,239
"Clarke County",-,"501 - Buckmarsh",110,70,0,180
"Clarke County",-,"502 - Blue Ridge",39,39,0,78
"Clarke County",-,"Ab - Central Absentee Precinct",34,23,0,57
"Clarke County",-,Provisional,0,0,0,0
"Fairfax County",-,"229 - Fox Mill",306,132,0,438
"Fairfax County",-,"240 - Colvin",208,49,0,257
"Fairfax County",-,"301 - Chain Bridge",257,52,0,309
"Fairfax County",-,"303 - Churchill",106,24,0,130
"Fairfax County",-,"304 - Cooper",179,20,0,199
"Fairfax County",-,"306 - Great Falls",217,48,0,265
"Fairfax County",-,"309 - Kenmore",280,75,0,355
"Fairfax County",-,"311 - Langley",218,39,0,257
"Fairfax County",-,"314 - Mclean",151,42,0,193
"Fairfax County",-,"321 - Clearview",206,103,0,309
"Fairfax County",-,"322 - Forestville",325,77,0,402
"Fairfax County",-,"323 - Shouse",154,51,0,205
"Fairfax County",-,"327 - Sugarland",199,77,0,276
"Fairfax County",-,"328 - Hickory",260,89,0,349
"Fairfax County",-,"329 - Seneca",269,116,0,385
"Fairfax County",-,"331 - Spring Hill",232,43,0,275
"Fairfax County",-,"803 - Clifton",309,202,0,511
"Fairfax County",-,"804 - Colchester",131,85,0,216
"Fairfax County",-,"805 - Fairfax Station",119,68,0,187
"Fairfax County",-,"815 - Woodyard",225,96,0,321
"Fairfax County",-,"838 - Sangster",145,68,0,213
"Fairfax County",-,"839 - Silverbrook",231,112,0,343
"Fairfax County",-,"841 - Popes Head",142,64,0,206
"Fairfax County",-,"845 - Fountainhead",290,127,0,417
"Fairfax County",-,"847 - Greenbriar West",128,63,0,191
"Fairfax County",-,"849 - Newgate",358,144,0,502
"Fairfax County",-,"850 - South Run",214,104,0,318
"Fairfax County",-,"902 - Brookfield",111,105,0,216
"Fairfax County",-,"903 - Cub Run",204,89,0,293
"Fairfax County",-,"904 - Stonecroft",63,68,0,131
"Fairfax County",-,"905 - Franklin",48,35,0,83
"Fairfax County",-,"908 - Hidden Meadow",131,62,0,193
"Fairfax County",-,"909 - Oak Hill",119,50,0,169
"Fairfax County",-,"911 - Navy",151,67,0,218
"Fairfax County",-,"913 - Rocky Run",187,117,0,304
"Fairfax County",-,"914 - Vale",131,63,0,194
"Fairfax County",-,"915 - Virginia Run",173,140,0,313
"Fairfax County",-,"916 - Waples Mill",263,133,0,396
"Fairfax County",-,"917 - Stone North",85,31,0,116
"Fairfax County",-,"920 - Chantilly",106,43,0,149
"Fairfax County",-,"921 - Deer Park",212,119,0,331
"Fairfax County",-,"923 - Bull Run",142,143,0,285
"Fairfax County",-,"925 - Old Mill",63,41,0,104
"Fairfax County",-,"927 - Armfield",61,37,0,98
"Fairfax County",-,"928 - Poplar Tree",169,62,0,231
"Fairfax County",-,"929 - Difficult Run",61,23,0,84
"Fairfax County",-,"930 - Lees Corner",98,73,0,171
"Fairfax County",-,"931 - Carson",72,53,0,125
"Fairfax County",-,"932 - Stone South",24,26,0,50
"Fairfax County",-,"Ab - Central Absentee Precinct",633,231,0,864
"Fairfax County",-,Provisional,6,1,0,7
"Frederick County",-,"101 - Russells",169,164,0,333
"Frederick County",-,"102 - Gore",102,173,0,275
"Frederick County",-,"103 - Kernstown",226,184,0,410
"Frederick County",-,"104 - Cedar Creek",89,79,0,168
"Frederick County",-,"201 - Gainesborough",90,149,0,239
"Frederick County",-,"202 - Albin",153,185,0,338
"Frederick County",-,"203 - Redland",171,202,0,373
"Frederick County",-,"204 - Nain",194,155,0,349
"Frederick County",-,"301 - Clear Brook",89,88,0,177
"Frederick County",-,"302 - Neff's Town",138,136,0,274
"Frederick County",-,"303 - White Hall",225,194,0,419
"Frederick County",-,"401 - Carpers Valley",164,145,0,309
"Frederick County",-,"402 - Shenandoah",76,83,0,159
"Frederick County",-,"403 - Parkin's Mill",90,143,0,233
"Frederick County",-,"404 - Armel",120,138,0,258
"Frederick County",-,"501 - Stephens City",162,169,0,331
"Frederick County",-,"502 - Newtown",139,173,0,312
"Frederick County",-,"503 - Canterburg",197,215,0,412
"Frederick County",-,"601 - Millbrook",90,92,0,182
"Frederick County",-,"602 - Ash Hollow",106,134,0,240
"Frederick County",-,"603 - Greenwood",169,260,0,429
"Frederick County",-,"Ab - Central Absentee Precinct",96,101,0,197
"Frederick County",-,Provisional,1,2,0,3
"Loudoun County",-,"107 - Little River",129,60,0,189
"Loudoun County",-,"108 - Mercer",87,64,0,151
"Loudoun County",-,"112 - Freedom",60,43,0,103
"Loudoun County",-,"114 - Dulles South",61,40,0,101
"Loudoun County",-,"117 - Carter",18,18,0,36
"Loudoun County",-,"118 - Moorefield",68,50,0,118
"Loudoun County",-,"119 - Arcola",127,97,0,224
"Loudoun County",-,"120 - Lunsford",107,41,0,148
"Loudoun County",-,"121 - Town Hall",91,34,0,125
"Loudoun County",-,"122 - Hutchison Farm",112,71,0,183
"Loudoun County",-,"123 - Cardinal Ridge",92,35,0,127
"Loudoun County",-,"124 - Liberty",74,51,0,125
"Loudoun County",-,"125 - Rock Ridge",62,21,0,83
"Loudoun County",-,"207 - River Bend",114,82,0,196
"Loudoun County",-,"208 - Algonkian",106,73,0,179
"Loudoun County",-,"209 - Potomac Falls",122,57,0,179
"Loudoun County",-,"210 - Cascades",108,76,0,184
"Loudoun County",-,"213 - Countryside",40,26,0,66
"Loudoun County",-,"214 - Sugarland North",296,78,0,374
"Loudoun County",-,"215 - Sugarland South",163,94,0,257
"Loudoun County",-,"216 - Lowes Island",184,70,0,254
"Loudoun County",-,"217 - South Bank",173,80,0,253
"Loudoun County",-,"218 - University Center",57,43,0,100
"Loudoun County",-,"219 - Galilee Church",74,74,0,148
"Loudoun County",-,"301 - Purcellville",181,81,0,262
"Loudoun County",-,"302 - Round Hill",227,129,0,356
"Loudoun County",-,"303 - Hillsboro",137,133,0,270
"Loudoun County",-,"305 - Philomont",97,55,0,152
"Loudoun County",-,"307 - Middleburg",88,49,0,137
"Loudoun County",-,"308 - St Louis",72,45,0,117
"Loudoun County",-,"309 - Aldie",68,45,0,113
"Loudoun County",-,"310 - Mountain View",171,94,0,265
"Loudoun County",-,"311 - Round Hill Elementary",181,94,0,275
"Loudoun County",-,"312 - Briar Woods",73,40,0,113
"Loudoun County",-,"313 - Pinebrook",115,79,0,194
"Loudoun County",-,"314 - Legacy",81,42,0,123
"Loudoun County",-,"315 - Firehouse",61,44,0,105
"Loudoun County",-,"316 - Creighton's Corner",84,40,0,124
"Loudoun County",-,"318 - Madison's Trust",116,86,0,202
"Loudoun County",-,"319 - John Champe",89,54,0,143
"Loudoun County",-,"320 - Stone Hill",47,23,0,70
"Loudoun County",-,"321 - Brambleton Middle",43,21,0,64
"Loudoun County",-,"401 - West Lovettsville",200,162,0,362
"Loudoun County",-,"402 - Waterford",190,120,0,310
"Loudoun County",-,"403 - Lucketts",172,120,0,292
"Loudoun County",-,"407 - Harper Park",72,57,0,129
"Loudoun County",-,"408 - Evergreen",121,80,0,201
"Loudoun County",-,"409 - Clarkes Gap",182,139,0,321
"Loudoun County",-,"411 - East Lovettsville",132,165,0,297
"Loudoun County",-,"413 - Tuscarora",8,6,0,14
"Loudoun County",-,"414 - Red Rock",67,42,0,109
"Loudoun County",-,"416 - Hamilton",246,145,0,391
"Loudoun County",-,"420 - River Creek",178,101,0,279
"Loudoun County",-,"421 - Between The Hills",19,25,0,44
"Loudoun County",-,"422 - Sycolin Creek",117,71,0,188
"Loudoun County",-,"501 - West Leesburg",145,94,0,239
"Loudoun County",-,"502 - East Leesburg",64,73,0,137
"Loudoun County",-,"503 - Dry Mill",76,55,0,131
"Loudoun County",-,"504 - Smarts Mill",140,75,0,215
"Loudoun County",-,"505 - Cool Spring",207,89,0,296
"Loudoun County",-,"506 - Brandon Park",65,40,0,105
"Loudoun County",-,"507 - Greenway",97,61,0,158
"Loudoun County",-,"508 - Balls Bluff",115,75,0,190
"Loudoun County",-,"509 - Tolbert",74,68,0,142
"Loudoun County",-,"510 - Heritage",90,61,0,151
"Loudoun County",-,"615 - Hillside",155,69,0,224
"Loudoun County",-,"616 - Eagle Ridge",147,54,0,201
"Loudoun County",-,"617 - Oak Grove",20,14,0,34
"Loudoun County",-,"619 - Ridgetop",17,18,0,35
"Loudoun County",-,"620 - Russell Branch",172,94,0,266
"Loudoun County",-,"621 - Dominion Trail",161,59,0,220
"Loudoun County",-,"622 - Farmwell Station",139,95,0,234
"Loudoun County",-,"623 - Weller",183,95,0,278
"Loudoun County",-,"625 - Mill Run",76,36,0,112
"Loudoun County",-,"626 - Ashby Ponds",202,69,0,271
"Loudoun County",-,"627 - Ashbrook",67,44,0,111
"Loudoun County",-,"628 - Moorefield Station",62,36,0,98
"Loudoun County",-,"629 - Discovery",26,18,0,44
"Loudoun County",-,"701 - Sully",89,82,0,171
"Loudoun County",-,"702 - Park View",104,53,0,157
"Loudoun County",-,"703 - Rolling Ridge",61,56,0,117
"Loudoun County",-,"705 - Forest Grove",128,93,0,221
"Loudoun County",-,"707 - Claude Moore Park",61,32,0,93
"Loudoun County",-,"708 - Seneca",141,69,0,210
"Loudoun County",-,"709 - Mirror Ridge",89,50,0,139
"Loudoun County",-,"710 - Sterling",82,56,0,138
"Loudoun County",-,"808 - Stone Bridge",130,84,0,214
"Loudoun County",-,"810 - Cedar Lane",76,60,0,136
"Loudoun County",-,"813 - Seldens Landing",61,41,0,102
"Loudoun County",-,"814 - Newton - Lee",175,76,0,251
"Loudoun County",-,"815 - Belmont Ridge",160,140,0,300
"Loudoun County",-,"817 - Sanders Corner",169,95,0,264
"Loudoun County",-,"818 - Broad Run",100,41,0,141
"Loudoun County",-,"819 - Heritage Church",114,67,0,181
"Loudoun County",-,"820 - Belmont Station",76,69,0,145
"Loudoun County",-,"822 - Riverside",67,44,0,111
"Loudoun County",-,"Ab - Central Absentee Precinct",391,226,0,617
"Loudoun County",-,Provisional,5,5,0,10
"Manassas City",-,"1 - Dean",91,96,0,187
"Manassas City",-,"2 - Weems",184,124,0,308
"Manassas City",-,"3 - Metz",155,132,0,287
"Manassas City",-,"4 - Haydon",186,95,0,281
"Manassas City",-,"5 - Baldwin",123,87,0,210
"Manassas City",-,"6 - Round",199,143,0,342
"Manassas City",-,"Ab - Central Absentee Precinct",108,52,0,160
"Manassas City",-,Provisional,0,2,0,2
"Manassas Park City",-,"1 - Precinct One",49,54,0,103
"Manassas Park City",-,"2 - Precinct Two",49,70,0,119
"Manassas Park City",-,"3 - Precinct Three",66,72,0,138
"Manassas Park City",-,"Ab - Central Absentee Precinct",29,9,0,38
"Manassas Park City",-,Provisional,0,0,0,0
"Prince William County",-,"110 - Buckland Mills",49,71,0,120
"Prince William County",-,"112 - Burke-nickens",81,143,0,224
"Prince William County",-,"205 - Buckhall",179,151,0,330
"Prince William County",-,"211 - Signal Hill",118,148,0,266
"Prince William County",-,"212 - Yorkshire",96,94,0,190
"Prince William County",-,"401 - Evergreen",188,197,0,385
"Prince William County",-,"402 - Battlefield",204,179,0,383
"Prince William County",-,"403 - Bull Run",81,84,0,165
"Prince William County",-,"406 - Alvey",163,92,0,255
"Prince William County",-,"407 - Heritage Hunt",414,346,3,763
"Prince William County",-,"409 - Tyler",72,102,0,174
"Prince William County",-,"410 - Mountain View",152,136,0,288
"Prince William County",-,"412 - Catharpin",117,148,0,265
"Prince William County",-,"413 - Reagan",160,157,0,317
"Prince William County",-,"510 - Yates Ford",176,122,0,298
"Prince William County",-,"Ab - Central Absentee Precinct",188,114,0,302
"Prince William County",-,Provisional,1,0,0,1
"Winchester City",-,"101 - Merrimans",207,104,0,311
"Winchester City",-,"102 - Old Town",150,96,0,246
"Winchester City",-,"201 - Virginia Avenue",65,64,0,129
"Winchester City",-,"301 - War Memorial",83,94,0,177
"Winchester City",-,"401 - Frederick Douglass",48,43,0,91
"Winchester City",-,"402 - Rolling Hills",141,100,0,241
"Winchester City",-,"Ab - Central Absentee Precinct",41,25,0,66
"Winchester City",-,Provisional,0,0,0,0
TOTALS,,,"28,287","18,311",3,"46,601"
